#,Top Core,Sub core,Agreement,Fixed Budget,Implementation,Internal Request,Policy,Total
1,S-TEAM,39 PAYMENTS,0,16,0,3,0,19
2,S-TEAM,45 ACCOUNTS DEPT,0,16,0,1,0,17
3,S-TEAM,93 CRM,0,10,0,4,0,14
4,S-TEAM,96 S TEAM,0,0,0,6,0,6
5,S-TEAM,113 AUDIT,0,0,0,16,0,16
6,S-TEAM,118 DATA BASE,0,0,0,5,0,5
7,S-TEAM,131 TRAVEL DESK,0,3,0,0,0,3
8,S-TEAM,136 GREEN TODAY,0,2,0,0,0,2
9,S-TEAM,137 COST CONTROL,0,1,0,5,0,6
10,MANAGEMENT,27 E.D.P,0,0,0,4,0,4
11,MANAGEMENT,53 NON-TEXTILES,0,47,0,0,0,47
12,MANAGEMENT,97 MIA DEPT,0,0,0,3,0,3
13,MANAGEMENT,104 TP,0,1,0,1,0,2
14,MANAGEMENT,114 TAILYOU,0,6,0,4,0,10
15,MANAGEMENT,117 PROCESS,0,0,0,2,0,2
16,MANAGEMENT,122 PACKING / GIFTING,0,0,0,3,0,3
17,MANAGEMENT,140 MANAGEMENT,0,0,0,5,0,5
18,MANAGEMENT,144 MASTER,0,0,0,15,0,15
19,OPERATION,READY MADE,0,0,0,42,0,42
20,OPERATION,TEXTILE,0,0,0,33,0,33
21,OPERATION,43 ADVERTISEMENT,0,150,0,3,0,153
22,OPERATION,82 PURCHASE TEAM,0,0,2,0,0,2
23,OPERATION,103 LOGISTICS,0,4,0,4,0,8
24,ADMIN,29 GODOWN,0,3,0,0,0,3
25,ADMIN,23 CANTEEN,0,9,0,0,0,9
26,ADMIN,28 ELECTRICAL,0,18,0,1,0,19
27,ADMIN,36 INFO TECH,0,2,2,16,0,20
28,ADMIN,26 CIVIL\HOUSE,0,14,0,0,0,14
29,ADMIN,30 OFFICE,1,48,0,16,2,67
30,ADMIN,85 ONLINE,0,0,0,1,0,1
31,ADMIN,92 PROJECT,0,106,0,9,0,115
32,ADMIN,95 HR DEPT,0,31,0,24,0,55
33,ADMIN,98 SALES TEAM,0,1,0,27,0,28
34,ADMIN,100 LIFT / ESCALATOR,0,3,0,0,0,3
35,ADMIN,106 HARDWARE-NETWORKING,0,144,0,14,0,158
36,ADMIN,107 PUR OFFICE TEAM,0,0,0,26,0,26
37,ADMIN,124 WELFARE,0,9,0,1,0,10
38,ADMIN,142 AIRPORT-ABROAD,0,1,0,0,0,1



 ,,S-TEAM
#,Core,Type Of Submission,Subject
1,93 CRM,INTERNAL REQUEST,CRM - STALL SALES INVITE SMS
2,93 CRM,INTERNAL REQUEST,CRM - STALL SALES INVITE MAIL
3,93 CRM,INTERNAL REQUEST,CLUB CUSTOMER SMS APPROVAL
4,93 CRM,INTERNAL REQUEST,SMS SEND APPROVAL
5,93 CRM,FIXED BUDGET,SUPPLIER MARRIGE GIFT
6,93 CRM,FIXED BUDGET,SILVER KAMBI PURCHASE APPROVAL
7,93 CRM,FIXED BUDGET,CUSTOMER GOLD COIN PURCHASE APPROVAL REG
8,93 CRM,FIXED BUDGET,WATER BOTTLE PURCHASE APPROVAL REG
9,93 CRM,FIXED BUDGET,AUTO SMS APPROVAL REG
10,93 CRM,FIXED BUDGET,CUSTOMER AWARD AND GIFT ISSUE APPROVAL REG
11,93 CRM,FIXED BUDGET,CUSTOMER GREETINGS POSTAL CHARGE REG
12,93 CRM,FIXED BUDGET,PAPER CUP PURCHASE APPROVAL REG
13,93 CRM,FIXED BUDGET,CUSOMER SWEET PURCHASE APPROVAL REG
14,93 CRM,FIXED BUDGET,CRM BEVERAGES PRODUCT PURCHASE APPROVAL REG
15,96 S TEAM,INTERNAL REQUEST,ULAVARAPANI PARTICIPATION APPROVAL
16,96 S TEAM,INTERNAL REQUEST,GREEN TODAY EVENT ARRANGR APPROVAL
17,96 S TEAM,INTERNAL REQUEST,GREEN TODAY PRODUCT ISSUE APPROVAL
18,96 S TEAM,INTERNAL REQUEST,TEMPLE CLEANNING STAFF DUTY TIME FIX APPROVAL
19,96 S TEAM,INTERNAL REQUEST,TEMPLE CLEANNING STAFF SALARY FIX APPROVAL
20,96 S TEAM,INTERNAL REQUEST,MD APPROVALS
21,45 ACCOUNTS DEPT,FIXED BUDGET,HALLMARK CERTIFICATION  LICENCE RENEWAL APPROVAL
22,45 ACCOUNTS DEPT,FIXED BUDGET,EMPLOYEE PROFESSIONAL TAX
23,45 ACCOUNTS DEPT,FIXED BUDGET,SECURITY DEPOSIT PAYMENT
24,45 ACCOUNTS DEPT,INTERNAL REQUEST,LOAN RENEWAL APPROVAL
25,45 ACCOUNTS DEPT,FIXED BUDGET,WINDMILL PAYMENT
26,45 ACCOUNTS DEPT,FIXED BUDGET,TDS PAYMENT
27,45 ACCOUNTS DEPT,FIXED BUDGET,CORPORATION TAX PAYMENT
28,45 ACCOUNTS DEPT,FIXED BUDGET,GST MONTHLY PAYMENT
29,45 ACCOUNTS DEPT,FIXED BUDGET,SECURITY DEPOSIT PAYMENT
30,45 ACCOUNTS DEPT,FIXED BUDGET,INSURANCE PAYMENT
31,45 ACCOUNTS DEPT,FIXED BUDGET,TRADE MARK REGISTRATION FEES PAYMENT
32,45 ACCOUNTS DEPT,FIXED BUDGET,REFUNDABLE AIRPORT SECURITY DEPOSIT
33,45 ACCOUNTS DEPT,FIXED BUDGET,PROFESSTIONAL TAX PAYMENT APPROVAL REG
34,45 ACCOUNTS DEPT,FIXED BUDGET,CONSULTING CHARGE APPROVAL REG
35,45 ACCOUNTS DEPT,FIXED BUDGET,STATUTARY  AUDIT FEES AND CHARGES PAYMENT APPROVAL REG
36,45 ACCOUNTS DEPT,FIXED BUDGET,INTERNAL AUDIT FEES AND CHARGES PAYMENT APPROVAL REG
37,45 ACCOUNTS DEPT,FIXED BUDGET,TAX AND LICENSE APPROVAL REG
38,113 AUDIT,INTERNAL REQUEST,ASSET INTER CHANGE APPROVAL
39,113 AUDIT,INTERNAL REQUEST,PHYSICAL STOCK DUE DATE CLOSE PENALTY
40,113 AUDIT,INTERNAL REQUEST,PHYSICAL STOCK PRICE TAG RE-PRINT OPTION
41,113 AUDIT,INTERNAL REQUEST,PHYSICAL STOCK TARGET NUMBER DELETE
42,113 AUDIT,INTERNAL REQUEST,PHYSICAL STOCK QTY SHORTAGE PENALTY
43,113 AUDIT,INTERNAL REQUEST,NEW PHYSICAL STOCK TAKEN
44,113 AUDIT,INTERNAL REQUEST,PHYSICAL STOCK - STOCK LESS
45,113 AUDIT,INTERNAL REQUEST,OTRS PEANALTY REVERSE
46,113 AUDIT,INTERNAL REQUEST,OTRS DUE DATE EXTEND 
47,113 AUDIT,INTERNAL REQUEST,MONTHLY FLASH REPORT
48,113 AUDIT,INTERNAL REQUEST,AUDIT - ASSETS PRODUCT CODE CREATE
49,113 AUDIT,INTERNAL REQUEST,AUDIT - ASSETS NEW PROCESS IMPLEMENTATION
50,113 AUDIT,INTERNAL REQUEST,AUDIT - BRANCH VISIT APPROVAL
51,113 AUDIT,INTERNAL REQUEST,AUDIT - GENERAL POLICY
52,113 AUDIT,INTERNAL REQUEST,AUDIT - GENERAL APPROVAL
53,113 AUDIT,INTERNAL REQUEST,WASTE QUOTATION RATE FIX - LOGISTIC
54,118 DATA BASE,INTERNAL REQUEST,MAIL ID CHANGE
55,118 DATA BASE,INTERNAL REQUEST,NEW MAIL ID CREATION
56,118 DATA BASE,INTERNAL REQUEST,SERVER DOWNTIME APPROVAL
57,118 DATA BASE,INTERNAL REQUEST,NEW DATABASE CREATION
58,118 DATA BASE,INTERNAL REQUEST,ORACLE AMC RENEWAL APPROVAL
59,131 TRAVEL DESK,FIXED BUDGET,TRAVEL RENTAL AND CHARGES APPROVAL REG
60,131 TRAVEL DESK,FIXED BUDGET,TRAVEL AND FOOD EXPENSES APPROVAL REG
61,131 TRAVEL DESK,FIXED BUDGET,TRAVEL TICKET BOOKING APPRVAL REG
62,136 GREEN TODAY,FIXED BUDGET,GREEN TODAY MATERIALS PURCHASE
63,136 GREEN TODAY,FIXED BUDGET,GREEN TODAY SERVICE CHARGES
64,137 COST CONTROL,INTERNAL REQUEST,NT PO - DUE DATE CHANGE APPROVAL
65,137 COST CONTROL,INTERNAL REQUEST,NT PO - LATE DELIVERY APPROVAL
66,137 COST CONTROL,INTERNAL REQUEST,NT PO - LATE PAYMENT APPROVAL
67,137 COST CONTROL,INTERNAL REQUEST,PENALTY REVERSE APPROVAL
68,137 COST CONTROL,FIXED BUDGET,BUSINESS SUPPORT SERVICE
69,137 COST CONTROL,INTERNAL REQUEST,EXTRA BUDGET APPROVAL
70,39 PAYMENTS,INTERNAL REQUEST,CASH PART SALARY
71,39 PAYMENTS,FIXED BUDGET,FUND TRANSFER
72,39 PAYMENTS,INTERNAL REQUEST,PAYMENT GATEWAY CHARGE APPROVAL
73,39 PAYMENTS,FIXED BUDGET,FUND TRANSFER 70 %
74,39 PAYMENTS,FIXED BUDGET,FUND TRANSFER 95 %
75,39 PAYMENTS,FIXED BUDGET,SUPPLIER PAYMENT APPROVAL
76,39 PAYMENTS,FIXED BUDGET,BANK CHARGES
77,39 PAYMENTS,FIXED BUDGET,KKV DHOTHY PROCESSING CHARGES
78,39 PAYMENTS,FIXED BUDGET,KKV DHOTHY FOLDING CHARGES
79,39 PAYMENTS,FIXED BUDGET,IRF  MEMBERSHIP RENEWAL APPROVAL
80,39 PAYMENTS,INTERNAL REQUEST,SALARY PROCESS APPROVAL
81,39 PAYMENTS,FIXED BUDGET,SUPPLIER PAYMENT APPROVAL
82,39 PAYMENTS,FIXED BUDGET,SUPPLIER PAYMENT DEDUCTION REVERSE
83,39 PAYMENTS,FIXED BUDGET,CREDIT CARD PAYMENT
84,39 PAYMENTS,FIXED BUDGET,MD PERSONAL EXPENSE
85,39 PAYMENTS,FIXED BUDGET,MD CREDIT CARD PAYMENT APPROVAL
86,39 PAYMENTS,FIXED BUDGET,FUND TRANSFER
87,39 PAYMENTS,FIXED BUDGET,MD ACCOUNT FUND TRANSFER APPROVAL
88,39 PAYMENTS,FIXED BUDGET,MD ACCOUNT FUND TRANSFER APPROVAL



 ,,MANAGAMENT
#,Core,Type Of Submission,Subject
1,114 TAILYOU,INTERNAL REQUEST,MATERIALS / ACCESSORIES REQ APPROVAL
2,114 TAILYOU,INTERNAL REQUEST,STYLE MASTER FOR WOMEN
3,114 TAILYOU,INTERNAL REQUEST,STYLE MASTER FOR MEN
4,114 TAILYOU,FIXED BUDGET,TAILYOU MATERIALS PURCHASE
5,114 TAILYOU,FIXED BUDGET,SWAROSKI STONE PURCHASE
6,114 TAILYOU,FIXED BUDGET,TAILYOU LABELS PURCHASE
7,114 TAILYOU,FIXED BUDGET,HANGER PURCHASE APPROVAL 
8,114 TAILYOU,FIXED BUDGET,TAILYOU ACCESSORIES ITEM PURCHASE
9,114 TAILYOU,FIXED BUDGET,TAILYOU TRIMS ITEM PURCHASE
10,114 TAILYOU,INTERNAL REQUEST,TAIL YOU - ART WORK APPROVAL
11,97 MIA DEPT,INTERNAL REQUEST,KPI FIX
12,97 MIA DEPT,INTERNAL REQUEST,NEW WORK ORDER CREATE
13,97 MIA DEPT,INTERNAL REQUEST,COUNTER FIXING
14,144 MASTER,INTERNAL REQUEST,SUPPLIER GRADE FIX
15,144 MASTER,INTERNAL REQUEST,COURIER FIX
16,144 MASTER,INTERNAL REQUEST,SALES RATE FIX
17,144 MASTER,INTERNAL REQUEST,PRODUCT SIZE FIX
18,144 MASTER,INTERNAL REQUEST,PRODUCT SUB MASTER
19,144 MASTER,INTERNAL REQUEST,SEASON PRODUCT ADD
20,144 MASTER,INTERNAL REQUEST,SUPPLIER GROUP ADD
21,144 MASTER,INTERNAL REQUEST,MRP SUPPLIER ADD
22,144 MASTER,INTERNAL REQUEST,NEW SECTION GROUP CREATE
23,144 MASTER,INTERNAL REQUEST,NEW SECTION CREATE
24,144 MASTER,INTERNAL REQUEST,SALES RANGE ADD
25,144 MASTER,INTERNAL REQUEST,NEW GROUP PRODUCT CREATE
26,144 MASTER,INTERNAL REQUEST,NEW PRODUCT CODE CREATE - NT
27,144 MASTER,INTERNAL REQUEST,NEW PRODUCT CODE CREATE
28,144 MASTER,INTERNAL REQUEST,NEW BRANCH CREATE
29,27 E.D.P,INTERNAL REQUEST,BARCODE STICKER PRINT OUT ALTER
30,27 E.D.P,INTERNAL REQUEST,SUPPLIER VISIT APPROVAL
31,27 E.D.P,INTERNAL REQUEST,BARCODE STICKER AND RIBBON PURCHASE
32,27 E.D.P,INTERNAL REQUEST,NEW BARCODE PRINTER PURCHASE
33,104 TP,FIXED BUDGET,TEST PURCHASE
34,104 TP,INTERNAL REQUEST,COMMON BUDGET APPROVAL
35,117 PROCESS,INTERNAL REQUEST,PROCESS ALTERATION
36,117 PROCESS,INTERNAL REQUEST,NEW PROCESS CREATION
37,122 PACKING / GIFTING,INTERNAL REQUEST,PACKING MATERIAL RATE FIX APPROVAL
38,122 PACKING / GIFTING,INTERNAL REQUEST,STAIONARY RATE FIX APPROVAL
39,122 PACKING / GIFTING,INTERNAL REQUEST,PACKING MATERIAL ART WORK APPROVAL
40,140 MANAGEMENT,INTERNAL REQUEST,SUPPLIER VISIT APPROVAL
41,140 MANAGEMENT,INTERNAL REQUEST,INTERTEK INLINE AUDIT REQUEST APPROVAL
42,140 MANAGEMENT,INTERNAL REQUEST,INTERTEK FINAL AUDIT REQUEST APPROVAL
43,140 MANAGEMENT,INTERNAL REQUEST,INTERTEK FACTORY EVALUATION APPROVAL
44,140 MANAGEMENT,INTERNAL REQUEST,INTERTEK AUDIT REQUEST APPROVAL
45,53 NON-TEXTILES,FIXED BUDGET,SILK SECTION BRAND  TAG PURCHASE
46,53 NON-TEXTILES,FIXED BUDGET,PENDING PAID PARCEL AMOUNT- REPAYMENT
47,53 NON-TEXTILES,FIXED BUDGET,SILK MARK STICKER PURCHASE
48,53 NON-TEXTILES,FIXED BUDGET,STICKER ROLL PURCHASE
49,53 NON-TEXTILES,FIXED BUDGET,STAFF GIFT  SWEET AND MIXTURE PURCHASE
50,53 NON-TEXTILES,FIXED BUDGET,SPONSER GIFT GIRIVALAM CARD  PURCHASE
51,53 NON-TEXTILES,FIXED BUDGET,IN SHOP GIFT FLOOR INFORMATION CARD PURCHASE
52,53 NON-TEXTILES,FIXED BUDGET,IN SHOP GIFT SPC CARD PURCHASE
53,53 NON-TEXTILES,FIXED BUDGET,SPONSER GIFT PRASATHA COVER PURCHASE
54,53 NON-TEXTILES,FIXED BUDGET,SPONSER GIFT TAILARING MATCHING GLASS PURCHASE
55,53 NON-TEXTILES,FIXED BUDGET,SPONSER GIFT SCHOOL NAME SLIP  PURCHASE
56,53 NON-TEXTILES,FIXED BUDGET,SPONSER GIFT SCHOOL TIME TABLE PURCHASE
57,53 NON-TEXTILES,FIXED BUDGET,SPONSER GIFT SCHOOL NOTE BOOK PURCHASE
58,53 NON-TEXTILES,FIXED BUDGET,SPONSER GIFT MUSLIM NOMBU CARD PURCHASE
59,53 NON-TEXTILES,FIXED BUDGET,SPONSER GIFT VIBOOTHI COVER PURCHASE
60,53 NON-TEXTILES,FIXED BUDGET,NEW YEAR GIFT MONTHLY PLANNER  PURCHASE
61,53 NON-TEXTILES,FIXED BUDGET,NEW YEAR GIFT VIVEKANANDA CALENDAR  PURCHASE
62,53 NON-TEXTILES,FIXED BUDGET,NEW YEAR GIFT CALENDAR CAKE PURCHASE
63,53 NON-TEXTILES,FIXED BUDGET,NEW YEAR GIFT MONTHLY CALENDAR PURCHASE
64,53 NON-TEXTILES,FIXED BUDGET,NEW YEAR GIFT DAILY CALENDAR PURCHASE
65,53 NON-TEXTILES,FIXED BUDGET,NEW YEAR GIFT DIARY PURCHASE
66,53 NON-TEXTILES,FIXED BUDGET,CUSTOMER ISSUE MARRIAGE GIFT PURCHASE
67,53 NON-TEXTILES,FIXED BUDGET,COMPLIMENT PURCHASE
68,53 NON-TEXTILES,FIXED BUDGET,KTM AND STJ DISPLAY ACCESSORIES PURCHASE
69,53 NON-TEXTILES,FIXED BUDGET,ALL SECTION PRODUCT PACKING PURPOSE
70,53 NON-TEXTILES,FIXED BUDGET,MAGNETIC SENSOR PURCHASE
71,53 NON-TEXTILES,FIXED BUDGET,LAMINATION SENSOR PURCHASE
72,53 NON-TEXTILES,FIXED BUDGET,GSM CHECKING MACHINE PURCHASE
73,53 NON-TEXTILES,FIXED BUDGET,KTM AND STJ PACKING MATERIAL PURCHASE
74,53 NON-TEXTILES,FIXED BUDGET,HANGER PURCHASE
75,53 NON-TEXTILES,FIXED BUDGET,TCS PACKING MATERIAL PURCHASE
76,53 NON-TEXTILES,FIXED BUDGET,VISITING CARD PURCHASE
77,53 NON-TEXTILES,FIXED BUDGET,LETTER HEAD A4 EXE.BOND PURCHASE
78,53 NON-TEXTILES,FIXED BUDGET,DEBIT NOTE (1+2) PURCHASE PURCHASE
79,53 NON-TEXTILES,FIXED BUDGET,PAYMENT ADVOICE (1+2) PURCHASE
80,53 NON-TEXTILES,FIXED BUDGET,SALES BILL (1+1) PURCHASE
81,53 NON-TEXTILES,FIXED BUDGET,LOGO SHEET 10 X 12 PURCHASE
82,53 NON-TEXTILES,FIXED BUDGET, INVOICE PURCHASE
83,53 NON-TEXTILES,FIXED BUDGET,INVOICE (BRANCH TRANSFER) PURCHASE
84,53 NON-TEXTILES,FIXED BUDGET,CHIT CARD PURCHASE 
85,53 NON-TEXTILES,FIXED BUDGET,DATA SHEET PURCHASE
86,53 NON-TEXTILES,FIXED BUDGET,SALARY COVER PURCHASE
87,53 NON-TEXTILES,FIXED BUDGET,THERMAL PAPER ROLL PURCHASE
88,53 NON-TEXTILES,FIXED BUDGET,PRINTING STATIONARY PURCHASE
89,53 NON-TEXTILES,FIXED BUDGET,130 COLUM PAPER PURCHASE
90,53 NON-TEXTILES,FIXED BUDGET,A4 PAPER PURCHASE
91,53 NON-TEXTILES,FIXED BUDGET,STATIONARY GENERAL PURCHASE



 ,,OPERATION
#,Core,Type Of Submission,Subject
1,103 LOGISTICS,FIXED BUDGET,LORRY FREIGHT PAYMENT APPROVAL
2,103 LOGISTICS,FIXED BUDGET,RAIL FREIGHT PAYMENT APPROVAL
3,103 LOGISTICS,FIXED BUDGET,AIR FREIGHT PAYMENT APPROVAL
4,43 ADVERTISEMENT,FIXED BUDGET,HOARDINGS RENTAL APPROVAL
5,43 ADVERTISEMENT,FIXED BUDGET,MINI HOARDINGS RENTAL APPROVAL
6,43 ADVERTISEMENT,FIXED BUDGET,BUS SHELTER MONTHLY RENTAL APPROVAL
7,43 ADVERTISEMENT,FIXED BUDGET,BUS PANNEL MONTHLY RENTAL APPROVAL
8,43 ADVERTISEMENT,FIXED BUDGET,SIGNAL BOARD RENTAL APPROVAL
9,43 ADVERTISEMENT,FIXED BUDGET,AUTO PANNEL MONTHLY RENTAL APPROVAL
10,43 ADVERTISEMENT,FIXED BUDGET,CAMERA POLE MONTHLY RENTAL APPROVAL
11,43 ADVERTISEMENT,FIXED BUDGET,POLE MONTHLY RENTAL APPROVALS
12,43 ADVERTISEMENT,FIXED BUDGET,MEDIAN MONTHLY RENTAL APPROVAL
13,43 ADVERTISEMENT,FIXED BUDGET,RAILYWAY ADVERTISEMENT APPROVAL
14,43 ADVERTISEMENT,FIXED BUDGET,AIRPORT MEDIAS ADVERTISEMENT APPROVAL
15,43 ADVERTISEMENT,FIXED BUDGET,LACAL MAGAZINE MONTHLY RENTAL APPROVAL
16,43 ADVERTISEMENT,FIXED BUDGET,LOCAL CHANNEL MONTHLY RENTAL APPORVAl
17,43 ADVERTISEMENT,FIXED BUDGET,BARRY CARD RE-WORK APPROVAL
18,43 ADVERTISEMENT,FIXED BUDGET,FLEX PRINTING APPROVAL
19,43 ADVERTISEMENT,FIXED BUDGET,DIRECTORYS PRINITNG APPROVAL
20,43 ADVERTISEMENT,FIXED BUDGET,SPONSORSHIP APPROVAL 
21,43 ADVERTISEMENT,FIXED BUDGET,NOTICE PRINTING APPROVAL
22,43 ADVERTISEMENT,FIXED BUDGET,INVITATION PRINTING APPROVAL
23,43 ADVERTISEMENT,FIXED BUDGET,CUTOUT PRINTING AND FIXING APPROVAL
24,43 ADVERTISEMENT,FIXED BUDGET,BANERS FIXING APPROVAL
25,43 ADVERTISEMENT,FIXED BUDGET,FLUTE BOARD PRINTING APPROVAL
26,43 ADVERTISEMENT,FIXED BUDGET,VINYL PRINITNG APPROVAL
27,43 ADVERTISEMENT,FIXED BUDGET,FOAM BOARD PRINTING APPROVAL
28,43 ADVERTISEMENT,FIXED BUDGET,FOAM WITH VINYL PRINTING 
29,43 ADVERTISEMENT,FIXED BUDGET,WALL POSTER PRINITNG APPROVAL
30,43 ADVERTISEMENT,FIXED BUDGET,BACK LIGHT PRINITNG APPROVAL
31,43 ADVERTISEMENT,FIXED BUDGET,FRONT ARCH PRINTING  APPROVAL
32,43 ADVERTISEMENT,FIXED BUDGET,DANGLER PRINITNG APPROVAL
33,43 ADVERTISEMENT,FIXED BUDGET,IN LIGHT FLEX PRINITNG APPROVAL
34,43 ADVERTISEMENT,FIXED BUDGET,TRANSOLITE FLEX PRINTING APPROVAL
35,43 ADVERTISEMENT,FIXED BUDGET,DIGITAL POSTER PRINTING APPROVAL
36,43 ADVERTISEMENT,FIXED BUDGET,PAPER INSERT APPROVAl
37,43 ADVERTISEMENT,FIXED BUDGET,TRANSPORT EXPENSES
38,43 ADVERTISEMENT,FIXED BUDGET,RAILWAY ADVERTISEMENT APPROVAL
39,43 ADVERTISEMENT,FIXED BUDGET,CATELOUGE PRINTING APPROVAL
40,43 ADVERTISEMENT,FIXED BUDGET,LEAF LET PAMPLETS PRINTING APPROVAL
41,43 ADVERTISEMENT,FIXED BUDGET,HANGING CHAIN BOARD PRINTING APPROVAL
42,43 ADVERTISEMENT,FIXED BUDGET,SUN BOARD PRINITNG APPROVAL
43,43 ADVERTISEMENT,FIXED BUDGET,PROMOTIONAL ITEM PURCHASE APPROVAL
44,43 ADVERTISEMENT,FIXED BUDGET,ROLLUP STANDEE PRINTING APPROVAL
45,43 ADVERTISEMENT,FIXED BUDGET,ACRYLIC SIGN BOARD PRINTIING APPROVAL
46,43 ADVERTISEMENT,FIXED BUDGET,LED SIGNAGE PRINITNG AND FIXING APPROVAL
47,43 ADVERTISEMENT,FIXED BUDGET,ROAD SHOW ADVERTISEMENT APPROVAL
48,43 ADVERTISEMENT,FIXED BUDGET,WALL PAINITNG APPROVAL
49,43 ADVERTISEMENT,FIXED BUDGET,WALL PAINITNG RENTAL APPROVAL
50,43 ADVERTISEMENT,FIXED BUDGET,LOCAL CHANNEL MEDIA ADVERTISEMENT
51,43 ADVERTISEMENT,FIXED BUDGET,BUS STAND ADVERTISEMENT APPROVAL
52,43 ADVERTISEMENT,FIXED BUDGET,LABOUR PAYMENT APPROVAl
53,43 ADVERTISEMENT,FIXED BUDGET,LED BOARD PRINTING AND FIXING APPROVAL
54,,INTERNAL REQUEST,SUNDAY DUTY APPROVAL-TEXTILE
55,,INTERNAL REQUEST,PJV REVERSE OR DELETE APPOVAL-TEXTILE
56,,INTERNAL REQUEST,PURCHASE ENTRY APPROVAL-TEXTILE
57,,INTERNAL REQUEST,SET ITEM CODE CHANGE APPROVAL-TEXTILE
58,,INTERNAL REQUEST,ROL FIX APPROVAL -READYMADE
59,,INTERNAL REQUEST,REQ QTY ARRIVAL APPROVAL -READYMADE
60,,INTERNAL REQUEST,COUNTER ROL FILE ALTER APPROVAL-READYMADE
61,,INTERNAL REQUEST,MU ALTER REG-READYMADE
62,,INTERNAL REQUEST,STAFF LEAVE APPROVAL -READYMADE
63,,INTERNAL REQUEST,PO RELEASE AND SPLIT APPROVAL -READYMADE
64,,INTERNAL REQUEST,AUTO PENALTY REVERSE APPROVAL-READYMADE
65,,INTERNAL REQUEST,STOCK AND SALES CHANGE- READYMADE
66,,INTERNAL REQUEST,SUPPLIER PAYMENT PROCESS APPROVAL -READYMADE
67,,INTERNAL REQUEST,L.R.AGAINST PAYMENT APPROVAL-READYMADE
68,,INTERNAL REQUEST,BRAND LOGO SEAL MAKE APPROVAL-READYMADE
69,,INTERNAL REQUEST,OWN BRAND LABLE STICHING APPROVAL-READYMADE
70,,INTERNAL REQUEST,VISITING CARD REQUIRMENT -READYMADE
71,,INTERNAL REQUEST,PO DELETE AND PO QTY CANCEL APPROVAL-READYMADE
72,,INTERNAL REQUEST,PO DISCOUNT EDIT APPROVAL-READYMADE
73,,INTERNAL REQUEST,PO RATE EDIT APPROVAL-READYMADE
74,,INTERNAL REQUEST,LR ENTRY DELETE - READYMADE
75,,INTERNAL REQUEST,AUTO ORDER FIX APPROVAL -READYMADE
76,,INTERNAL REQUEST,SALES NOTE PO RELEASE APPROVAL -READYMADE
77,,INTERNAL REQUEST,PO DUE DATE LOCK OPEN -READYMADE
78,,INTERNAL REQUEST,GODOWN TO SECTION TRANSFER APPROVAL-READYMADE
79,,INTERNAL REQUEST,AUTO ORDER FIX ALTER APPROVAL-READYMADE
80,,INTERNAL REQUEST,BRANCH VISIT APPROVAL - READYMADE
81,,INTERNAL REQUEST,PURCHASE VISIT APPROVAL - READYMADE
82,,INTERNAL REQUEST,RATE CHANGE APPROVAL-READYMADE
83,,INTERNAL REQUEST,SUNDAY DUTY APPROVAL-READYMADE
84,,INTERNAL REQUEST,PJV REVERSE OR DELETE APPOVAL-READYMADE
85,,INTERNAL REQUEST,PURCHASE ENTRY APPROVAL-READYMADE
86,,INTERNAL REQUEST,SET ITEM CODE CHANGE APPROVAL-READYMADE
87,43 ADVERTISEMENT,INTERNAL REQUEST,ART WORK  APPROVAL - ADVERTISEMENT
88,103 LOGISTICS,INTERNAL REQUEST,TRANSPORT FREIGHT AMOUNT FIX - LOGISTIC
89,103 LOGISTICS,INTERNAL REQUEST,CHECK POST PAYMENT - LOGISTIC
90,103 LOGISTICS,INTERNAL REQUEST,TRANSPORT DEBIT - LOGISTIC
91,,INTERNAL REQUEST,ROL FIX APPROVAL -TEXTILE
92,,INTERNAL REQUEST,REQ QTY ARRIVAL APPROVAL -TEXTILE
93,,INTERNAL REQUEST,COUNTER ROL FILE ALTER APPROVAL-TEXTILE
94,,INTERNAL REQUEST,MU ALTER REG-TEXTILE
95,,INTERNAL REQUEST,STAFF LEAVE APPROVAL -TEXTILE
96,,INTERNAL REQUEST,PO RELEASE AND SPLIT APPROVAL -TEXTILE
97,,INTERNAL REQUEST,AUTO PENALTY REVERSE APPROVAL-TEXTILE
98,,INTERNAL REQUEST,STOCK AND SALES CHANGE- TEXTILE
99,,INTERNAL REQUEST,SUPPLIER PAYMENT PROCESS APPROVAL -TEXTILE
100,,INTERNAL REQUEST,L.R.AGAINST PAYMENT APPROVAL-TEXTILE
101,,INTERNAL REQUEST,BRAND LOGO SEAL MAKE APPROVAL-TEXTILE
102,,INTERNAL REQUEST,OWN BRAND LABLE STICHING APPROVAL-TEXTILE
103,,INTERNAL REQUEST,VISITING CARD REQUIRMENT -TEXTILE
104,,INTERNAL REQUEST,PO DELETE AND PO QTY CANCEL APPROVAL-TEXTILE
105,,INTERNAL REQUEST,PO DISCOUNT EDIT APPROVAL-TEXTILE
106,,INTERNAL REQUEST,PO RATE EDIT APPROVAL-TEXTILE
107,,INTERNAL REQUEST,LR ENTRY DELETE - TEXTILE
108,,INTERNAL REQUEST,AUTO ORDER FIX APPROVAL -TEXTILE
109,,INTERNAL REQUEST,SALES NOTE PO RELEASE APPROVAL -TEXTILE
110,,INTERNAL REQUEST,PO DUE DATE LOCK OPEN -TEXTILE
111,,INTERNAL REQUEST,GODOWN TO SECTION TRANSFER APPROVAL-TEXTILE
112,,INTERNAL REQUEST,AUTO ORDER FIX ALTER APPROVAL-TEXTILE
113,,INTERNAL REQUEST,BRANCH VISIT APPROVAL - TEXTILE
114,,INTERNAL REQUEST,PURCHASE VISIT APPROVAL - TEXTILE
115,,INTERNAL REQUEST,RATE CHANGE APPROVAL-TEXTILE
116,82 PURCHASE TEAM,IMPLEMENTATION,MARKET RESEARCH 
117,,INTERNAL REQUEST,GOODS BOOKING FOR CATALOG SHOOTING - READYMADE
118,,INTERNAL REQUEST,SUPPLIER ACTIVE AND DEACTIVE APPROVAL - TEXTILE
119,,INTERNAL REQUEST,WOS RETURN SLIP DELETE - READY MADE
120,,INTERNAL REQUEST,WOS RETURN SLIP DELETE - TEXTILE
121,43 ADVERTISEMENT,FIXED BUDGET,VM- PROPS / MATERIAL PURCHASE
122,43 ADVERTISEMENT,FIXED BUDGET,VM-PONGAL CAMPAIGN
123,43 ADVERTISEMENT,FIXED BUDGET,VM- SPECIAL DAYS CAMPAIGN
124,43 ADVERTISEMENT,FIXED BUDGET,VM- LABOUR PAYMENT
125,43 ADVERTISEMENT,FIXED BUDGET,THEATRE OFF SCREEN ADVERTISEMENT
126,43 ADVERTISEMENT,FIXED BUDGET,ADVT - DIWALI NEWSPAPER
127,43 ADVERTISEMENT,FIXED BUDGET,ADVT - MUGURTHAM NEWSPAPER
128,43 ADVERTISEMENT,FIXED BUDGET,ADVT - AADI TV RELEASE
129,43 ADVERTISEMENT,FIXED BUDGET,ADVT - PONGAL CATALOGUE
130,43 ADVERTISEMENT,FIXED BUDGET,ADVT - ONAM MAGAZINE
131,43 ADVERTISEMENT,FIXED BUDGET,ADVT - SUMMER FM
132,43 ADVERTISEMENT,FIXED BUDGET,ADVT - SUMMER MAGAZINE
133,43 ADVERTISEMENT,FIXED BUDGET,ADVT - ONAM CATALOGUE
134,43 ADVERTISEMENT,FIXED BUDGET,ADVT - X-MAS TV RELEASE
135,43 ADVERTISEMENT,INTERNAL REQUEST,ADVT BUDGET APPROVAL
136,43 ADVERTISEMENT,FIXED BUDGET,BUDGET APPROVAL
137,43 ADVERTISEMENT,FIXED BUDGET,TWITTER AD
138,,INTERNAL REQUEST,GOODS BOOKING FOR CATALOG SHOOTING - TEXTILE
139,,INTERNAL REQUEST,PO REVERSE APPROVAL - TEXTILE
140,,INTERNAL REQUEST,SUPPLIER ACTIVE AND DEACTIVE APPROVAL - READY MADE
141,43 ADVERTISEMENT,FIXED BUDGET,FLUTE BOARD PRINTING APPROVAL
142,43 ADVERTISEMENT,FIXED BUDGET,PROMOTIONAL ITEM PURCHASE APPROVAL
143,43 ADVERTISEMENT,FIXED BUDGET,LED SIGN BOARD WITH PRINT PURCHASE APPROVAL
144,43 ADVERTISEMENT,FIXED BUDGET,CATALOGUE PRINTING APPROVAL
145,43 ADVERTISEMENT,FIXED BUDGET,LED BOARD PURCHASE
146,43 ADVERTISEMENT,FIXED BUDGET,FLEX PRINTING APPROVAL
147,43 ADVERTISEMENT,FIXED BUDGET,DANGLER PRINTING APPROVAL
148,43 ADVERTISEMENT,FIXED BUDGET,VINYL WITH FOAM BOARD PRINTING AND FIXING APPROVAL
149,43 ADVERTISEMENT,FIXED BUDGET,DIGITAL POSTERS PRINTING APPROVAL
150,43 ADVERTISEMENT,FIXED BUDGET,DIRECTORY PURCHASE APPROVAL
151,43 ADVERTISEMENT,FIXED BUDGET,FOAM BOARD DIRECT PRINT AND PURCHASE APPROVAL
152,43 ADVERTISEMENT,FIXED BUDGET,WALL POSTERS PRINTING APPROVAL
153,43 ADVERTISEMENT,FIXED BUDGET,ROLLUP STANDEE PURCHASE WITH PRINTING APPROVAL
154,43 ADVERTISEMENT,FIXED BUDGET,SHOP FRONT ARCH PRINTING AND FIXING APPROVAL
155,43 ADVERTISEMENT,FIXED BUDGET,INVITATION PRINTING APPROVAL
156,43 ADVERTISEMENT,FIXED BUDGET,VINYL PRINTING APPROVAL
157,43 ADVERTISEMENT,FIXED BUDGET,HANGING BOARD WITH CHAIN PRINTING APPROVAL
158,43 ADVERTISEMENT,FIXED BUDGET,SUN BOARD PRINTING APPROVAL
159,43 ADVERTISEMENT,FIXED BUDGET,ACRYLIC SHEET PURCHASE APPROVAL
160,43 ADVERTISEMENT,FIXED BUDGET,ACRYLIC SIGN BOARD WITH PRINT PURCHASE APPROVAL
161,,INTERNAL REQUEST,ZF & ZSF PO DELETE AND QTY CANCEL APPROVAL
162,,INTERNAL REQUEST,ZF & ZSF PO DUE DATE LOCK OPEN APPROVAL
163,,INTERNAL REQUEST,ZF & ZSF PO RELEASE AND SPLIT APPROVAL
164,,INTERNAL REQUEST,ZF & ZSF PO REVERSE APPROVAL
165,,INTERNAL REQUEST,ZF & ZSF PO DISCOUNT EDIT APPROVAL
166,,INTERNAL REQUEST,ZF & ZSF PO RATE CHANGE APPROVAL
167,,INTERNAL REQUEST,ZF & ZSF PO CONCEPTION EDIT APPROVAL
168,43 ADVERTISEMENT,FIXED BUDGET,VM-AADI CAMPAIGN
169,43 ADVERTISEMENT,FIXED BUDGET,VM-MANNEQUIN PURCHASE
170,43 ADVERTISEMENT,FIXED BUDGET,VM-MUGURTHAM CAMPAIGN
171,43 ADVERTISEMENT,FIXED BUDGET,VM- PURCHASE / LABOUR PAYMENT
172,43 ADVERTISEMENT,FIXED BUDGET,VM-SUMMER CAMPAIGN
173,43 ADVERTISEMENT,FIXED BUDGET,VM-NEW YEAR CAMPAIGN
174,43 ADVERTISEMENT,FIXED BUDGET,VM-ONAM CAMPAIGN
175,43 ADVERTISEMENT,FIXED BUDGET,VM-DIWALI CAMPAIGN
176,43 ADVERTISEMENT,FIXED BUDGET,VM- SPECIAL DISPLAYS
177,43 ADVERTISEMENT,FIXED BUDGET,ADVT - DIWALI CATALOGUE
178,43 ADVERTISEMENT,FIXED BUDGET,ADVT - PONGAL NEWSPAPER
179,43 ADVERTISEMENT,FIXED BUDGET,ADVT - PONGAL FM
180,43 ADVERTISEMENT,FIXED BUDGET,ADVT - ONAM FM
181,43 ADVERTISEMENT,FIXED BUDGET,ADVT - SUMMER NEWSPAPER
182,43 ADVERTISEMENT,FIXED BUDGET,ADVT - MUGURTHAM CATALOGUE
183,43 ADVERTISEMENT,FIXED BUDGET,ADVT - PONGAL TV RELEASE
184,43 ADVERTISEMENT,FIXED BUDGET,ADVT - X-MAS NEWSPAPER
185,43 ADVERTISEMENT,FIXED BUDGET,ADVT - AADI NEWSPAPER
186,43 ADVERTISEMENT,FIXED BUDGET,ADVT - DIWALI MAGAZINE
187,43 ADVERTISEMENT,FIXED BUDGET,ADVT - SUMMER TV RELEASE
188,43 ADVERTISEMENT,FIXED BUDGET,ADVT - MUGURTHAM TV RELEASE
189,43 ADVERTISEMENT,FIXED BUDGET,ADVT - X-MAS FM
190,43 ADVERTISEMENT,FIXED BUDGET,ADVT - X-MAS CATALOGUE
191,43 ADVERTISEMENT,FIXED BUDGET,ADVT - NEW YEAR FM
192,43 ADVERTISEMENT,FIXED BUDGET,ADVT - DIWALI FM
193,43 ADVERTISEMENT,FIXED BUDGET,ADVT - MUGURTHAM FM
194,43 ADVERTISEMENT,FIXED BUDGET,ADVT - MUGURTHAM MAGAZINE
195,43 ADVERTISEMENT,FIXED BUDGET,ADVT - ONAM TV RELEASE
196,43 ADVERTISEMENT,FIXED BUDGET,ADVT - ONAM NEWSPAPER
197,43 ADVERTISEMENT,FIXED BUDGET,ADVT - NEW YEAR TV RELEASE
198,43 ADVERTISEMENT,FIXED BUDGET,ADVT - AADI MAGAZINE
199,43 ADVERTISEMENT,FIXED BUDGET,ADVT - AADI CATALOGUE
200,43 ADVERTISEMENT,FIXED BUDGET,ADVT - DIWALI TV RELEASE
201,43 ADVERTISEMENT,FIXED BUDGET,ADVT - NEW YEAR NEWSPAPER
202,43 ADVERTISEMENT,FIXED BUDGET,ADVT - AADI FM
203,43 ADVERTISEMENT,FIXED BUDGET,ADVT - SUMMER CATALOGUE
204,43 ADVERTISEMENT,FIXED BUDGET,ADVT - X-MAS MAGAZINE
205,43 ADVERTISEMENT,FIXED BUDGET,ADVT - NEW YEAR MAGAZINE
206,43 ADVERTISEMENT,FIXED BUDGET,ADVT - NEW YEAR CATALOGUE
207,103 LOGISTICS,FIXED BUDGET,LORRY FREIGHT BUDGET APPROVAL
208,43 ADVERTISEMENT,FIXED BUDGET,EVENT APPROVAL - REG
209,43 ADVERTISEMENT,FIXED BUDGET,MAGAZINE APPROVAL - REG
210,43 ADVERTISEMENT,FIXED BUDGET,NEWSPAPER APPROVAL - REG
211,43 ADVERTISEMENT,FIXED BUDGET,PHOTOSHOOT APPROVAL - REG
212,43 ADVERTISEMENT,FIXED BUDGET,FM MEDIA APPROVAL REG
213,43 ADVERTISEMENT,FIXED BUDGET,SPONSORSHIP APPROVAL - REG
214,43 ADVERTISEMENT,FIXED BUDGET,TV MEDIA APPROVAL REG
215,43 ADVERTISEMENT,FIXED BUDGET,THEATRE AD APPROVAL - REG
216,43 ADVERTISEMENT,FIXED BUDGET,TVC SHOOTING APPROVAL - REG
217,,INTERNAL REQUEST,PO REVERSE APPROVAL - READY MADE
218,43 ADVERTISEMENT,FIXED BUDGET,VM-MUGURTHAM CAMPAIGN
219,43 ADVERTISEMENT,FIXED BUDGET,VM-XMAS  CAMPAIGN
220,43 ADVERTISEMENT,FIXED BUDGET,VM-AADI CAMPAIGN
221,43 ADVERTISEMENT,FIXED BUDGET,VM-MANNEQUIN PURCHASE
222,43 ADVERTISEMENT,FIXED BUDGET,VM-SUMMER CAMPAIGN
223,43 ADVERTISEMENT,FIXED BUDGET,VM-NEW YEAR CAMPAIGN
224,43 ADVERTISEMENT,FIXED BUDGET,VM-DIWALI CAMPAIGN
225,,INTERNAL REQUEST,ZF & ZSF PRODUCT COSTING
226,82 PURCHASE TEAM,IMPLEMENTATION,CONSIGNMENT BASICS SALES
227,43 ADVERTISEMENT,FIXED BUDGET,VM-XMAS  CAMPAIGN
228,43 ADVERTISEMENT,INTERNAL REQUEST,ADVERTISEMENT GENERAL WORK APPROVAL
229,43 ADVERTISEMENT,FIXED BUDGET,ADVT - PONGAL MAGAZINE
230,,INTERNAL REQUEST,ZF & ZSF STYLE MASTER
231,43 ADVERTISEMENT,FIXED BUDGET,VM-PONGAL CAMPAIGN
232,43 ADVERTISEMENT,FIXED BUDGET,ROAD SHOW AND NOTICE CATALOGUE DISTRIBUTE
233,43 ADVERTISEMENT,FIXED BUDGET,ANIMATION - VOICE OVER
234,43 ADVERTISEMENT,FIXED BUDGET,ANIMATION - MAKING CHARGES
235,43 ADVERTISEMENT,FIXED BUDGET,FACEBOOK AD
236,43 ADVERTISEMENT,FIXED BUDGET,YOUTUBE AD
237,43 ADVERTISEMENT,FIXED BUDGET,WHATS UP AD
238,103 LOGISTICS,INTERNAL REQUEST,AIR BUNDLE BOOKING - LOGISTIC



 ,,POLICY
#,Core,Type Of Submission,Subject
1,28 ELECTRICAL,FIXED BUDGET,ELECTRICAL MATERIALS PURCHASE
2,92 PROJECT,FIXED BUDGET,ELECTRICAL - LABOUR PAYMENT
3,100 LIFT / ESCALATOR,FIXED BUDGET,ELECTRICAL - MAINTENANCE PROCESS
4,28 ELECTRICAL,FIXED BUDGET,ELECTRICAL - CASH PAYMENT
5,28 ELECTRICAL,FIXED BUDGET,ELECTRICAL - RENEWAL PAYMENT
6,26 CIVIL\HOUSE,FIXED BUDGET,CIVIL LABOUR WEEKLY PAYMENT APPROVAL
7,26 CIVIL\HOUSE,FIXED BUDGET,CIVIL WORK LABOUR WITH MATERIAL APPROVAL
8,26 CIVIL\HOUSE,FIXED BUDGET,CIVIL WORK ADVANCE PAYMENT APPROVAL
9,26 CIVIL\HOUSE,FIXED BUDGET,CIVIL DEMOLISHING WORK APROVAL
10,26 CIVIL\HOUSE,FIXED BUDGET,CIVIL MAINTENANCE WORK APPROVAL
11,26 CIVIL\HOUSE,FIXED BUDGET,CIVIL MAINTENANCE WORK PAYMENT APPROVAL
12,92 PROJECT,FIXED BUDGET,NEW FLOORING MATERIAL PURCHASE APPROVAL
13,92 PROJECT,FIXED BUDGET,FLOORING LABOUR PAYMENT APPROVAL
14,92 PROJECT,FIXED BUDGET,NEW ELEVATION WORK APPROVAL
15,92 PROJECT,FIXED BUDGET,ELEVATION MAINTEANCE WORK APPROVAL
16,92 PROJECT,FIXED BUDGET,ELEVATION CLEANING WORK APPROVAL
17,92 PROJECT,FIXED BUDGET,NEW SITE FENCING WORK APPROVAL
18,92 PROJECT,FIXED BUDGET,SITE EARTH WORK APPROVAL
19,92 PROJECT,FIXED BUDGET,SITE GROUND LEVELLING WORK APPROVAL
20,92 PROJECT,FIXED BUDGET,MS MATERIAL PURCHASE APPROVAL
21,92 PROJECT,FIXED BUDGET,MS LABOUR WORK APPROVAL
22,92 PROJECT,FIXED BUDGET,WELDING WORK APPROVAL
23,92 PROJECT,FIXED BUDGET,SHED WORK APPROVAL
24,92 PROJECT,FIXED BUDGET,SHED ALTERATION WORK APPROVAL
25,92 PROJECT,FIXED BUDGET,ALTERATION WORK APPROVAL
26,92 PROJECT,FIXED BUDGET,DRAWING APPROVAL
27,92 PROJECT,FIXED BUDGET,NEW ACCESSORIES PURCHASE APPROVAL
28,92 PROJECT,FIXED BUDGET,NEW SITE PAINTING WORK APPROVAL
29,92 PROJECT,FIXED BUDGET,FALSE CEILING PAINTING WORK APPROVAL
30,92 PROJECT,FIXED BUDGET,BUILDING OUTER PAINTING APPROVAL
31,92 PROJECT,FIXED BUDGET,PRIMER APPLY WORK APPROVAL
32,92 PROJECT,FIXED BUDGET,ENAMEL AND MRF PAINTING APPROVAL
33,92 PROJECT,FIXED BUDGET,SCAFFLODING WORK APPROVAL
34,92 PROJECT,FIXED BUDGET,SCAFFOLDING EXTENSION WORK APPROVAL
35,92 PROJECT,FIXED BUDGET,FLOOR CONCRETE WORK APPROVAL
36,92 PROJECT,FIXED BUDGET,BASEMENT FOUNDATION CONCRETE WORK APPROVAL
37,92 PROJECT,FIXED BUDGET,BARBED WORK PATMENT APPROVAL
38,92 PROJECT,FIXED BUDGET,WATER PROOFING WORK APPROVAL
39,92 PROJECT,FIXED BUDGET,SHUTTER WORK APPROVAL
40,92 PROJECT,FIXED BUDGET,SHUTTER ALTER WORK APPROVAL
41,92 PROJECT,FIXED BUDGET,CARPENTRY MATERIAL PURCHASE APPROVAL
42,92 PROJECT,FIXED BUDGET,CARPENTRY LABOUR WORK APPROVAL
43,92 PROJECT,FIXED BUDGET,CARPENTRY HARDWARE MATERIAL PURCHASE APPROVAL
44,92 PROJECT,FIXED BUDGET,WALL PAPER WORK APPROVAL
45,92 PROJECT,FIXED BUDGET,WALL PAPER RE-WORK APPROVAL
46,92 PROJECT,FIXED BUDGET,WOODEN FLOORING WORK APPROVAL
47,92 PROJECT,FIXED BUDGET,WOODEN FLOORING RE-WORK APPROVAL
48,92 PROJECT,FIXED BUDGET,BLINDS PURCHASE APPROVAL
49,92 PROJECT,FIXED BUDGET,MOSQUITO NET PURCHASE APPROVAL
50,30 OFFICE,FIXED BUDGET,COURIER CHARGE PAYMENT APPROVAL
51,30 OFFICE,FIXED BUDGET,VEHICLE FUEL PAYMENT APPROVAL
52,30 OFFICE,FIXED BUDGET,CHECK POST PENALTY SUPPLIER PAID 
53,30 OFFICE,FIXED BUDGET,CHECK POST PENALTY TCS PAID 
54,30 OFFICE,POLICY,NEW POLICY CREATE APPROVAL
55,29 GODOWN,FIXED BUDGET,GODOWN ACCESSORIES PURCHASE
56,29 GODOWN,FIXED BUDGET,GODOWN CARTON BOX PURCHASE
57,29 GODOWN,FIXED BUDGET,GODOWN STORAGE TRAY PURCHASE
58,36 INFO TECH,IMPLEMENTATION,SERVER IMPLEMENTATION
59,30 OFFICE,AGREEMENT,AGREEMENT NEW PROPOSAL  
60,95 HR DEPT,FIXED BUDGET,ESI PAYMENT APPROVAL REG
61,95 HR DEPT,FIXED BUDGET,EDLI PAYMENT APPROVAL REG
62,95 HR DEPT,FIXED BUDGET,ESI  LATE PAYMENT APPROVAL REG
63,95 HR DEPT,FIXED BUDGET,EPF PAYMENT APPROVAL REG
64,95 HR DEPT,FIXED BUDGET,EPF LATE PAYMENT APPROVAL REG
65,95 HR DEPT,FIXED BUDGET,WELFARE PAYMENT APPROVAL REG
66,95 HR DEPT,FIXED BUDGET,BONUS APPROVAL REG
67,95 HR DEPT,FIXED BUDGET,SALARY PAYMENT APPROVAL REG
68,95 HR DEPT,FIXED BUDGET,SALARY ADVANCE PAYMENT APPROVAL REG
69,95 HR DEPT,FIXED BUDGET,INTERVIEW APPROVAL REG
70,95 HR DEPT,FIXED BUDGET,STAFF TRAINING APPROVAL REG
71,95 HR DEPT,FIXED BUDGET,MONTHLY TARGET REACH GIFT ISSUE APPROVAL REG
72,95 HR DEPT,FIXED BUDGET,BIRTHDAY GIFT ISSUE APPROVAL REG
73,95 HR DEPT,FIXED BUDGET,MONTHLY MEETING CHIEF GUEST GIFT ISSUE APPROVAL REG
74,95 HR DEPT,FIXED BUDGET,SPL EVENTS STAFF GIFT ISSUE APPROVAL REG
75,95 HR DEPT,FIXED BUDGET,MONTHLY MEETING EXPENSES APPROVAL REG
76,95 HR DEPT,FIXED BUDGET,SPECIAL SWEET PURCHASE APPROVAL REG
77,95 HR DEPT,FIXED BUDGET,LADDU / CAKE PURCHASE APPROVAL REG
78,95 HR DEPT,FIXED BUDGET,THEFT IDENTIFY GIFT ISSUE APPROVAL REG
79,124 WELFARE,FIXED BUDGET,TARGET REACH TOUR APPROVAL REG
80,124 WELFARE,FIXED BUDGET,YEARLY STAFF TOUR APPROVAL REG
81,124 WELFARE,FIXED BUDGET,STAFF MARRIAGE GIFT ISSUE APPROVAL REG
82,124 WELFARE,FIXED BUDGET,HOSTEL RENT AND HOSTEL PAYMENTS APPROVAL REG
83,124 WELFARE,FIXED BUDGET,HOSTEL CHEMICAL SPRAY APPROVAL REG
84,124 WELFARE,FIXED BUDGET,HOSTEL NEWS PAPER PURCHASE APPROVAL REG
85,124 WELFARE,FIXED BUDGET,HOSTEL STAFF EQUIPMENT PURCHASE APPROVAL REG
86,124 WELFARE,FIXED BUDGET,HOSTEL ELECTRICAL MATERIAL PURCHASE APPROVAL REG
87,95 HR DEPT,FIXED BUDGET,SECURITY ACCESSORIES PURCHASE APPROVAL REG
88,124 WELFARE,FIXED BUDGET,HOSTEL WATER PURCHASE APPROVAL REG
89,95 HR DEPT,FIXED BUDGET,SEASON STAFF SALARY APPROVAL REG
90,95 HR DEPT,FIXED BUDGET, STAFF CHILDREN EDUCATION PAYMENT APPROVAL REG
91,95 HR DEPT,FIXED BUDGET,STAFF MEDICAL TREATMENT AND MEDICINE PURCHASE APPROVAL REG
92,95 HR DEPT,FIXED BUDGET,STAFF GAME ITEMS PURCHASE APPROVAL REG
93,95 HR DEPT,FIXED BUDGET,STAFF INSURANCE PAYMENT APPROVAL REG
94,95 HR DEPT,FIXED BUDGET,YOGA MASTER PAYMENT APPROVAL REG
95,95 HR DEPT,FIXED BUDGET,STAFF REFERRAL INCENTIVE APPROVAL REG
96,23 CANTEEN,FIXED BUDGET,CANTEEN GROCERY AND PROVISIONAL ITEM PURCHASE APPROVAL REG
97,23 CANTEEN,FIXED BUDGET,CANTEEN VEGETABLES AND FRUITS PURCHASE APPROVAL REG
98,23 CANTEEN,FIXED BUDGET,CANTEEN SERVICE PAYMENT APPROVAL REG
99,23 CANTEEN,FIXED BUDGET,CANTEEN MONTHLY PAYMENT APPROVAL REG
100,23 CANTEEN,FIXED BUDGET,FUNCTION FOOD PAYMENT APPROVAL REG
101,23 CANTEEN,FIXED BUDGET,CANTEEN STOVE SERVICE PAYMENT APPROVAL REG
102,23 CANTEEN,FIXED BUDGET,CANTEEN SNACKS PURCHASE APPROVAL REG
103,30 OFFICE,FIXED BUDGET,COURIER PAYMENT APPROVAL REG
104,30 OFFICE,FIXED BUDGET,VISITERS COMPLIMENTS PURCHASE APPROVAL REG
105,30 OFFICE,FIXED BUDGET,FLOWER PURCHASE APPROVAL REG
106,30 OFFICE,FIXED BUDGET,OFFICE EQUIPMENTS PURCHASE APPROVAL REG
107,30 OFFICE,FIXED BUDGET,POOJA ITEM PURCHASE APPROVAL REG
108,30 OFFICE,FIXED BUDGET,FLOWER POT AND BOQUE PURCHASE APPROVAL 
109,30 OFFICE,FIXED BUDGET,ADMIN RELATED EXPENSES APPROVAL REG
110,30 OFFICE,FIXED BUDGET,TAILORING EQUIPMENTS PURCHASE PAYMENT APPROVAL REG
111,30 OFFICE,FIXED BUDGET,PETTY CASH PAYMENT APPROVAL REG
112,30 OFFICE,FIXED BUDGET,MONTHLY RENT PAYMENT APPROVAL REG
113,30 OFFICE,FIXED BUDGET,VEHICLE SERVICE APPROVAL REG
114,30 OFFICE,FIXED BUDGET,VEHICLE INSURANCE APPROVAL REG
115,30 OFFICE,FIXED BUDGET,TWO WHEELER PURCHASE APPROVAL REG
116,30 OFFICE,FIXED BUDGET,FOUR WHEELER PURCHASE APPROVAL REG\
117,30 OFFICE,FIXED BUDGET,OFFICE ASSET PURCHASE APPROVAL REG
118,30 OFFICE,FIXED BUDGET,SHOP USING ASSET PURCHASE APPROVAL REG
119,23 CANTEEN,FIXED BUDGET,CANTEEN ASSET PURCHASE APPROVAL REG
120,30 OFFICE,POLICY,EXISTING POLICY ALTER / RENEWAL APPROVAL
121,95 HR DEPT,FIXED BUDGET,GAME SHOW CONDUCT APPROVAL REG
122,30 OFFICE,FIXED BUDGET,DATA SHEET AND SURVEY FORM PURCHASE APPROVAL REG
123,30 OFFICE,FIXED BUDGET,GREETINGS PURCHASE APPROVAL REG
124,30 OFFICE,FIXED BUDGET,WEDDING CUSTOMER PHOTO LAMINATION APPROVAL REG
125,30 OFFICE,FIXED BUDGET,ADDRESS STICKER PURCHASE APPROVAL REG
126,30 OFFICE,FIXED BUDGET,MASTER AND VIVAHA CARD, CRM ITEM PURCHASE APPROVAL REG
127,30 OFFICE,FIXED BUDGET,HOUSE KEEPING MATERIAL PURCHASE APPROVAL REG
128,30 OFFICE,FIXED BUDGET,ICS STAFF MONTHLY PAYMENT APPROVAL REG
129,30 OFFICE,FIXED BUDGET,CHEMICAL SPRAY APPROVAL REG
130,30 OFFICE,FIXED BUDGET,CLEANING CHANRGE APPROVAL REG
131,30 OFFICE,FIXED BUDGET,HOUSE KEEPING MACHINE SPARE PARTS PURCHASE APPROVAL REG
132,92 PROJECT,FIXED BUDGET,SS ACCESSORIES PURCHASE APPROVAL
133,92 PROJECT,FIXED BUDGET,NEW PRODUCT PURCHASE APPROVAL
134,92 PROJECT,FIXED BUDGET,NEW WORK BUDGET APPROVAL
135,92 PROJECT,FIXED BUDGET,REPAIR WORK APPROVAL
136,92 PROJECT,FIXED BUDGET,NEW PRODUCT PURCHASE APPROVAL
137,92 PROJECT,FIXED BUDGET,REPAIR WORK APPROVAL
138,26 CIVIL\HOUSE,FIXED BUDGET,CIVIL MATERIAL PURCHASE APPROVAL
139,26 CIVIL\HOUSE,FIXED BUDGET,CIVIL LABOUR WEEKLY PAYMENT APPROVAL
140,26 CIVIL\HOUSE,FIXED BUDGET,CIVIL WORK LABOUR WITH MATERIAL APPROVAL
141,30 OFFICE,INTERNAL REQUEST,NEW APPROVAL SUBJECT CREATE
142,28 ELECTRICAL,FIXED BUDGET,ELECTRICAL MATERIAL PURCHASE APPROVAL
143,26 CIVIL\HOUSE,FIXED BUDGET,CIVIL WORK ADVANCE PAYMENT APPROVAL
144,26 CIVIL\HOUSE,FIXED BUDGET,CIVIL DEMOLISHING WORK APROVAL
145,26 CIVIL\HOUSE,FIXED BUDGET,CIVIL MAINTENANCE WORK APPROVAL
146,26 CIVIL\HOUSE,FIXED BUDGET,CIVIL MAINTENANCE WORK PAYMENT APPROVAL
147,92 PROJECT,FIXED BUDGET,NEW FLOORING MATERIAL PURCHASE APPROVAL
148,92 PROJECT,FIXED BUDGET,FLOORING LABOUR PAYMENT APPROVAL
149,92 PROJECT,FIXED BUDGET,NEW ELEVATION WORK APPROVAL
150,92 PROJECT,FIXED BUDGET,ELEVATION MAINTEANCE WORK APPROVAL
151,92 PROJECT,FIXED BUDGET,ELEVATION CLEANING WORK APPROVAL
152,92 PROJECT,FIXED BUDGET,NEW SITE FENCING WORK APPROVAL
153,92 PROJECT,FIXED BUDGET,SITE EARTH WORK APPROVAL
154,92 PROJECT,FIXED BUDGET,SITE GROUND LEVELLING WORK APPROVAL
155,92 PROJECT,FIXED BUDGET,MS MATERIAL PURCHASE APPROVAL
156,92 PROJECT,FIXED BUDGET,MS LABOUR WORK APPROVAL
157,92 PROJECT,FIXED BUDGET,WELDING WORK APPROVAL
158,92 PROJECT,FIXED BUDGET,SHED WORK APPROVAL
159,92 PROJECT,FIXED BUDGET,SHED ALTERATION WORK APPROVAL
160,92 PROJECT,FIXED BUDGET,ALTERATION WORK APPROVAL
161,92 PROJECT,FIXED BUDGET,DRAWING APPROVAL
162,92 PROJECT,FIXED BUDGET,NEW ACCESSORIES PURCHASE APPROVAL
163,92 PROJECT,FIXED BUDGET,NEW SITE PAINTING WORK APPROVAL
164,92 PROJECT,FIXED BUDGET,FALSE CEILING PAINTING WORK APPROVAL
165,92 PROJECT,FIXED BUDGET,BUILDING OUTER PAINTING APPROVAL
166,92 PROJECT,FIXED BUDGET,PRIMER APPLY WORK APPROVAL
167,92 PROJECT,FIXED BUDGET,ENAMEL AND MRF PAINTING APPROVAL
168,92 PROJECT,FIXED BUDGET,SCAFFLODING WORK APPROVAL
169,92 PROJECT,FIXED BUDGET,SCAFFOLDING EXTENSION WORK APPROVAL
170,92 PROJECT,FIXED BUDGET,FLOOR CONCRETE WORK APPROVAL
171,92 PROJECT,FIXED BUDGET,BASEMENT FOUNDATION CONCRETE WORK APPROVAL
172,92 PROJECT,FIXED BUDGET,BARBED WORK PATMENT APPROVAL
173,92 PROJECT,FIXED BUDGET,WATER PROOFING WORK APPROVAL
174,92 PROJECT,FIXED BUDGET,SHUTTER WORK APPROVAL
175,92 PROJECT,FIXED BUDGET,SHUTTER ALTER WORK APPROVAL
176,92 PROJECT,FIXED BUDGET,CARPENTRY MATERIAL PURCHASE APPROVAL
177,92 PROJECT,FIXED BUDGET,CARPENTRY LABOUR WORK APPROVAL
178,92 PROJECT,FIXED BUDGET,CARPENTRY HARDWARE MATERIAL PURCHASE APPROVAL
179,92 PROJECT,FIXED BUDGET,WALL PAPER WORK APPROVAL
180,92 PROJECT,FIXED BUDGET,WALL PAPER RE-WORK APPROVAL
181,92 PROJECT,FIXED BUDGET,WOODEN FLOORING WORK APPROVAL
182,92 PROJECT,FIXED BUDGET,WOODEN FLOORING RE-WORK APPROVAL
183,92 PROJECT,FIXED BUDGET,BLINDS PURCHASE APPROVAL
184,92 PROJECT,FIXED BUDGET,MOSQUITO NET PURCHASE APPROVAL
185,26 CIVIL\HOUSE,FIXED BUDGET,CIVIL MATERIAL PURCHASE APPROVAL
186,92 PROJECT,INTERNAL REQUEST,NEW PROJECT  CONTRACTOR LABOUR HOSTEL STAY AND  FOOD ACCOMENDTION APPROVAL
187,30 OFFICE,INTERNAL REQUEST,DIWALI LEAVE AND DOUBLE WAGES 
188,30 OFFICE,INTERNAL REQUEST,PONGAL LEAVE AND DOUBLE WAGES
189,30 OFFICE,INTERNAL REQUEST,ACCOUNTING YEAR POOJA 
190,30 OFFICE,INTERNAL REQUEST,BUTTER MILK ISSUE 
191,30 OFFICE,INTERNAL REQUEST,STAFF NIGHT DUTY APPROVAL
192,30 OFFICE,INTERNAL REQUEST,GATEPASS RETURN AND NON-RETURN CHANGE APPROVAL
193,30 OFFICE,INTERNAL REQUEST,UNIFORM APPROVAL 
194,36 INFO TECH,INTERNAL REQUEST,IT - NEW TABLE CREATION
195,36 INFO TECH,INTERNAL REQUEST,IT - TABLE ALTER
196,36 INFO TECH,INTERNAL REQUEST,IT - NEW OPTION CREATION
197,36 INFO TECH,INTERNAL REQUEST,SOFTWARE ALTERATION APPROVAL
198,36 INFO TECH,INTERNAL REQUEST,MD APPROVAL FOR SOFTWARE CREATION / ALTERATION
199,36 INFO TECH,INTERNAL REQUEST,ROL FIXING / TUNING APPROVAL
200,36 INFO TECH,INTERNAL REQUEST,BONUS SLAB / VALUE APPROVAL
201,36 INFO TECH,INTERNAL REQUEST,DISCOUNT MASTER CARD
202,36 INFO TECH,INTERNAL REQUEST,BEFORE COMMISSION WORK PROCESS
203,36 INFO TECH,INTERNAL REQUEST,GIFT VOUCHER SLAB / VALUE APPROVAL
204,36 INFO TECH,INTERNAL REQUEST,TCS MIS - REPORT PERMISSION APPROVAL
205,36 INFO TECH,INTERNAL REQUEST,TCS PORTAL - REPORT PERMISSION APPROVAL
206,36 INFO TECH,INTERNAL REQUEST,TCS CENTRA - PERMISSION APPROVAL
207,36 INFO TECH,INTERNAL REQUEST,TCS ACCOUNTS - PERMISSION APPROVAL
208,36 INFO TECH,INTERNAL REQUEST,TCS MOBILE APP - PERMISSION APPROVAL
209,107 PUR OFFICE TEAM,INTERNAL REQUEST,JEWELLERY ADVERTISEMENT ARTWORK APPROVAL
210,107 PUR OFFICE TEAM,INTERNAL REQUEST,JEWELLERY BRANCH VISIT
211,107 PUR OFFICE TEAM,INTERNAL REQUEST,JEWELLERY CHIT COMPLIMENT SLAB
212,107 PUR OFFICE TEAM,INTERNAL REQUEST,JEWELLERY CHIT SCHEME AND NAME CHANGE APPROVAL
213,107 PUR OFFICE TEAM,INTERNAL REQUEST,JEWELLERY DESPATCH ENTRY AND SALES INVOICE DELETE
214,107 PUR OFFICE TEAM,INTERNAL REQUEST,JEWELLERY HALLMARK ENTRY DELETE
215,107 PUR OFFICE TEAM,INTERNAL REQUEST,JEWELLERY NEW SCHEME APPROVAL
216,107 PUR OFFICE TEAM,INTERNAL REQUEST,JEWELLERY PJV ENTRY DELETE
217,107 PUR OFFICE TEAM,INTERNAL REQUEST,JEWELLERY PJV LOCATION CHANGE
218,107 PUR OFFICE TEAM,INTERNAL REQUEST,JEWELLERY REPAIR AND POLISHING
219,107 PUR OFFICE TEAM,INTERNAL REQUEST,JEWELLERY ROL FIXING AND ALTER
220,107 PUR OFFICE TEAM,INTERNAL REQUEST,JEWELLERY SUPPLIER ADVANCE PAYMENT
221,107 PUR OFFICE TEAM,INTERNAL REQUEST,JEWELLERY SUPPLIER RETURN
222,107 PUR OFFICE TEAM,INTERNAL REQUEST,JEWELLERY TAG ENTRY DELETE
223,107 PUR OFFICE TEAM,INTERNAL REQUEST,JEWELLERY TAG WEIGHT EDIT
224,107 PUR OFFICE TEAM,INTERNAL REQUEST,JEWELLERY WEIGHT TO WEIGHT EXCHANGE
225,107 PUR OFFICE TEAM,INTERNAL REQUEST,JEWELLERY WASTAGE REVISE
226,107 PUR OFFICE TEAM,INTERNAL REQUEST,JEWELLERY YEAR/MONTH CODE CHANGE
227,107 PUR OFFICE TEAM,INTERNAL REQUEST,JEWELLERY STALL / EXHIBITION APPROVAL
228,107 PUR OFFICE TEAM,INTERNAL REQUEST,JEWELLERY CUSTOMER MISSING OG/OS DEPOSIT APPROVAL
229,107 PUR OFFICE TEAM,INTERNAL REQUEST,JEWELLERY NEW PACKING MATERIAL / GIFT APPROVAL
230,107 PUR OFFICE TEAM,INTERNAL REQUEST,JEWELLERY MELTING APPROVAL
231,107 PUR OFFICE TEAM,INTERNAL REQUEST,JEWELLERY PURCHASE SUPPLIER VISIT / EXHIBITION
232,107 PUR OFFICE TEAM,INTERNAL REQUEST,JEWELLERY DISCOUNT SCHEME APPROVAL
233,107 PUR OFFICE TEAM,INTERNAL REQUEST,JEWELLERY AKVN UNDIAL AMOUNT DEPOSIT APPROVAL
234,106 HARDWARE-NETWORKING,FIXED BUDGET,SERVER HOSTING
235,92 PROJECT,FIXED BUDGET,MONTHLY EB BILL
236,92 PROJECT,FIXED BUDGET,GENSET DIESEL PURCHASE
237,36 INFO TECH,INTERNAL REQUEST,SMS SUPPLIER QUOTATION APPROVAL 
238,92 PROJECT,FIXED BUDGET,GENERATOR AMC RENEWAL PAYMENT
239,92 PROJECT,FIXED BUDGET,MONTHLY EB BILL PAYMENT
240,92 PROJECT,FIXED BUDGET,CASH PAYMENT
241,92 PROJECT,FIXED BUDGET,EB DEPOSIT PAYMENT
242,100 LIFT / ESCALATOR,FIXED BUDGET,LIFT MATERIAL PURCHASE & LABOUR CHARGES
243,28 ELECTRICAL,FIXED BUDGET,ELECTRICAL MATERIAL PURCHASE & LABOUR CHARGES
244,36 INFO TECH,FIXED BUDGET,SMS PURCHASE
245,98 SALES TEAM,FIXED BUDGET,STALL SALES APPROVAL
246,95 HR DEPT,INTERNAL REQUEST,STAFF WEEKLY OFF APPROVAL
247,30 OFFICE,FIXED BUDGET,FLOWER PURCHASE
248,28 ELECTRICAL,FIXED BUDGET,MATERIAL PURCHASE AND LABOUR CHARGES
249,106 HARDWARE-NETWORKING,INTERNAL REQUEST,ASSET CHANGE APPROVAL 
250,106 HARDWARE-NETWORKING,FIXED BUDGET,HARDWARE GOODS SERVICE
251,95 HR DEPT,FIXED BUDGET,STAFF RECREATION 
252,30 OFFICE,INTERNAL REQUEST,ABSENT EMPLOYEE ADVANCE PENDING AMOUNT CONVERT
253,30 OFFICE,FIXED BUDGET,TRAVEL EXPENSE CLAIM APPROVAL
254,30 OFFICE,FIXED BUDGET,DIGITAL SURVEY CONSULTING PAYMENT APPROVAL
255,30 OFFICE,FIXED BUDGET,GREEN GARDENS WATER PURCHASE APPROVAL
256,30 OFFICE,FIXED BUDGET,MATERIALS SPONSOR APPROVAL
257,30 OFFICE,FIXED BUDGET,ULAVARAPANI MATERIALS SPONSOR APPROVAL
258,30 OFFICE,FIXED BUDGET,MONTHLY RENT PAYMENT APPROVAL REG
259,106 HARDWARE-NETWORKING,FIXED BUDGET,MONTHLY SERVICE CHARGE 
260,30 OFFICE,INTERNAL REQUEST,APPROVAL SUBJECT FLOW ALTER
261,106 HARDWARE-NETWORKING,FIXED BUDGET,RAILTEL ADVANCE PAYMENT
262,124 WELFARE,INTERNAL REQUEST,STAFF UNIFORM TARGET VALUE ADD APPROVAL
263,30 OFFICE,FIXED BUDGET,MD VEHICLE SERVICE APPROVAL
264,92 PROJECT,FIXED BUDGET,VASTHU CONSULTING FEES
265,92 PROJECT,FIXED BUDGET,GREEN LAND PROJECT PAYMENT
266,30 OFFICE,INTERNAL REQUEST,OLD APPROVAL RENEWAL REG
267,92 PROJECT,INTERNAL REQUEST,NEW PROJECT BUDGET APPROVAL
268,142 AIRPORT-ABROAD,FIXED BUDGET,MARKETING FEES
269,30 OFFICE,FIXED BUDGET,ACCESSORIES PURCHASE AND SERVICE 
270,23 CANTEEN,FIXED BUDGET,MILK PURCHASE 
271,95 HR DEPT,FIXED BUDGET,HOSTEL NEWS PAPER PURCHASE PAYMENT APPROVAL
272,30 OFFICE,FIXED BUDGET,AKNC CANTEEN PAYMENT
273,98 SALES TEAM,INTERNAL REQUEST,APPROXIMATE RATE NON-TEXTILES
274,30 OFFICE,INTERNAL REQUEST,NEW TARGET NUMBER CREATE
275,30 OFFICE,INTERNAL REQUEST,FC NEW PRODUCT ADD AND RATE INCREASE APPROVAL
276,30 OFFICE,FIXED BUDGET,OS MELTING CHRAGE PAYMENT
277,92 PROJECT,FIXED BUDGET,AMC PAYMENT
278,92 PROJECT,FIXED BUDGET,MAINTENANACE ADVANCE REQUEST
279,106 HARDWARE-NETWORKING,FIXED BUDGET,PAPPER SHREDDER PURCHASE
280,106 HARDWARE-NETWORKING,FIXED BUDGET,DESKTOP PURCHASE
281,106 HARDWARE-NETWORKING,FIXED BUDGET,APPLE SYSTEM PURCHASE
282,106 HARDWARE-NETWORKING,FIXED BUDGET,AIO DESKTOP PURCHASE
283,106 HARDWARE-NETWORKING,FIXED BUDGET,NC SYSTEM PURCHASE
284,106 HARDWARE-NETWORKING,FIXED BUDGET,SEVER PURCHASE
285,106 HARDWARE-NETWORKING,FIXED BUDGET,LAPTOP PURCHASE
286,106 HARDWARE-NETWORKING,FIXED BUDGET,WEB CAMERA PURCHASE
287,106 HARDWARE-NETWORKING,FIXED BUDGET,DIGITEL CAMERA PURCHASE
288,106 HARDWARE-NETWORKING,FIXED BUDGET,VIDEO CONFERENCING DEVICE PURCHASE
289,106 HARDWARE-NETWORKING,FIXED BUDGET,DOT MATRIX PRINTER PURCHASE
290,106 HARDWARE-NETWORKING,FIXED BUDGET,LASER PRINTER PURCHASE
291,106 HARDWARE-NETWORKING,FIXED BUDGET,INKJET PRINTER PURCHASE
292,106 HARDWARE-NETWORKING,FIXED BUDGET,THERMAL PRINTER PURCHASE
293,106 HARDWARE-NETWORKING,FIXED BUDGET,BARCODE PRINTER PURCHASE
294,106 HARDWARE-NETWORKING,FIXED BUDGET,PASS BOOK PRINTER PURCHASE
295,106 HARDWARE-NETWORKING,FIXED BUDGET,PHOTO PRINTER PURCHASE
296,106 HARDWARE-NETWORKING,FIXED BUDGET,AIO PRINTER PURCHASE
297,106 HARDWARE-NETWORKING,FIXED BUDGET,ID CARD PRINTER PURCHASE
298,106 HARDWARE-NETWORKING,FIXED BUDGET,PORTABLE PRINTER PURCHASE
299,106 HARDWARE-NETWORKING,FIXED BUDGET,LABEL PRINTER PURCHASE
300,106 HARDWARE-NETWORKING,FIXED BUDGET,BARCODE SCANNER PURCHASE
301,106 HARDWARE-NETWORKING,FIXED BUDGET,IMAGE SCANNER PURCHASE
302,106 HARDWARE-NETWORKING,FIXED BUDGET,TAB PURCHASE
303,106 HARDWARE-NETWORKING,FIXED BUDGET,NETWORK DEVICE PURCHASE
304,106 HARDWARE-NETWORKING,FIXED BUDGET,NETWORK RACK PURCHASE
305,106 HARDWARE-NETWORKING,FIXED BUDGET,SECURITY DEVICE PURCHASE
306,106 HARDWARE-NETWORKING,FIXED BUDGET,WIFI DEVICE PURCHASE
307,106 HARDWARE-NETWORKING,FIXED BUDGET,POLE DISPLAY PURCHASE
308,106 HARDWARE-NETWORKING,FIXED BUDGET,KIOSK PURCHASE
309,106 HARDWARE-NETWORKING,FIXED BUDGET,BACKUP DEVICE PURCHASE
310,106 HARDWARE-NETWORKING,FIXED BUDGET,STORAGE DEVICE PURCHASE
311,106 HARDWARE-NETWORKING,FIXED BUDGET,SECURITY ACCESS DEVICE PURCHASE
312,106 HARDWARE-NETWORKING,FIXED BUDGET,WALKIE TALKIE PURCHASE
313,106 HARDWARE-NETWORKING,FIXED BUDGET,DVD PURCHASE
314,106 HARDWARE-NETWORKING,FIXED BUDGET,XEROX MACHINE PURCHASE
315,106 HARDWARE-NETWORKING,FIXED BUDGET,LAMINATION MACHIENE PURCHASE
316,106 HARDWARE-NETWORKING,FIXED BUDGET, DEPARTMENT MOBILE PURCHASE/
317,106 HARDWARE-NETWORKING,FIXED BUDGET,MOBILE POLICY PAYMENT AMOUNT DEPOSIT
318,106 HARDWARE-NETWORKING,FIXED BUDGET,MOBILE PHONE PURCHASE
319,106 HARDWARE-NETWORKING,FIXED BUDGET,DEPARTMENT MOBILE PURCHASE
320,106 HARDWARE-NETWORKING,FIXED BUDGET, MOBILE POLICY PAYMENT AMOUNT DEPOSIT
321,106 HARDWARE-NETWORKING,FIXED BUDGET,VOICE RECORDER PURCHASE
322,106 HARDWARE-NETWORKING,FIXED BUDGET,HANDHELD MACHINE PURCHASE
323,106 HARDWARE-NETWORKING,FIXED BUDGET,MAGIC MIRROR PURCHASE
324,106 HARDWARE-NETWORKING,FIXED BUDGET,VIDEO DOOR PHONE PURCHASE
325,106 HARDWARE-NETWORKING,FIXED BUDGET,COMPUTER SPEAKER PURCHASE
326,106 HARDWARE-NETWORKING,FIXED BUDGET,MOBILE POS PURCHASE
327,106 HARDWARE-NETWORKING,FIXED BUDGET,POS SYSTEM PURCHASE
328,106 HARDWARE-NETWORKING,FIXED BUDGET,DOOR ACCESS CONTROL PURPOSE
329,106 HARDWARE-NETWORKING,FIXED BUDGET,PROCESSOR PURCHASE
330,106 HARDWARE-NETWORKING,FIXED BUDGET,MOTHERBOARD PURCHASE
331,106 HARDWARE-NETWORKING,FIXED BUDGET,RAM PURCHASE
332,106 HARDWARE-NETWORKING,FIXED BUDGET,HARD DISK PURCHASE
333,106 HARDWARE-NETWORKING,FIXED BUDGET,CPU CABINET PURCAHSE
334,106 HARDWARE-NETWORKING,FIXED BUDGET,SMPS PURCAHSE
335,106 HARDWARE-NETWORKING,FIXED BUDGET,GRAPHICS CARD PURCHASE
336,106 HARDWARE-NETWORKING,FIXED BUDGET,MOUSE PURCHASE
337,106 HARDWARE-NETWORKING,FIXED BUDGET,KEYBOARD PURCHASE
338,106 HARDWARE-NETWORKING,FIXED BUDGET,MONITOR PURCHASE
339,106 HARDWARE-NETWORKING,FIXED BUDGET,PROJECTOR PURCHASE
340,106 HARDWARE-NETWORKING,FIXED BUDGET,PROJECTOR SCREEN PURCHASE
341,106 HARDWARE-NETWORKING,FIXED BUDGET,OPERATING SYSTEM PURCHASE
342,106 HARDWARE-NETWORKING,FIXED BUDGET,SOFTWARE PURCHASE
343,106 HARDWARE-NETWORKING,FIXED BUDGET,RAM PURCHASE
344,106 HARDWARE-NETWORKING,FIXED BUDGET,MOTHERBOARD PURCHASE
345,106 HARDWARE-NETWORKING,FIXED BUDGET,SMPS PURCHASE
346,106 HARDWARE-NETWORKING,FIXED BUDGET,INTERNAL HARDDISK PURCHASE
347,106 HARDWARE-NETWORKING,FIXED BUDGET,HEAD PHONE PURCHASE
348,106 HARDWARE-NETWORKING,FIXED BUDGET,PROCESSOR PURCHASE
349,106 HARDWARE-NETWORKING,FIXED BUDGET,NETWORK ACCESSORIES PURCHASE
350,106 HARDWARE-NETWORKING,FIXED BUDGET,DVD ROM PURCHASE
351,106 HARDWARE-NETWORKING,FIXED BUDGET,DVD WRITER PURCHASE
352,106 HARDWARE-NETWORKING,FIXED BUDGET,EXTERNAL HARD DISK PURCHASE
353,106 HARDWARE-NETWORKING,FIXED BUDGET,CABLE PURCHASE
354,106 HARDWARE-NETWORKING,FIXED BUDGET,RAID CARD PURCHASE
355,106 HARDWARE-NETWORKING,FIXED BUDGET,POWER SUPPLY PURCHASE
356,106 HARDWARE-NETWORKING,FIXED BUDGET,LAPTOP ACCESSORIES PURCHASE
357,106 HARDWARE-NETWORKING,FIXED BUDGET,CD/DVD PURCHASE
358,106 HARDWARE-NETWORKING,FIXED BUDGET,PEN DRIVE PURCHASE
359,106 HARDWARE-NETWORKING,FIXED BUDGET,ACCESSORIES PURCHASE
360,106 HARDWARE-NETWORKING,FIXED BUDGET,TECHNICAL SUPPORT
361,106 HARDWARE-NETWORKING,FIXED BUDGET,SMS CHARGES
362,106 HARDWARE-NETWORKING,FIXED BUDGET,CAMERA ACCESSORIES PURCHASE
363,106 HARDWARE-NETWORKING,FIXED BUDGET,WALKIE TALKIE RENEWAL
364,106 HARDWARE-NETWORKING,FIXED BUDGET,INSTALLATION / SUPPORT PAYMENT
365,106 HARDWARE-NETWORKING,FIXED BUDGET,PROJECTOR ACCESSORIES PURCHASE
366,106 HARDWARE-NETWORKING,FIXED BUDGET,WIRELESS ACCESSORIES PURCHASE
367,106 HARDWARE-NETWORKING,FIXED BUDGET,DESKTOP ACCESSORIES PURCHASE
368,106 HARDWARE-NETWORKING,FIXED BUDGET,FRIGHT CHARGES
369,106 HARDWARE-NETWORKING,FIXED BUDGET,PROJECTOR ACCESSORIES 
370,106 HARDWARE-NETWORKING,FIXED BUDGET,NETWORK ACCESSORIES PURCHASE
371,106 HARDWARE-NETWORKING,FIXED BUDGET,PRINTER TONER PURCHASE 
372,106 HARDWARE-NETWORKING,FIXED BUDGET,PRINTER CARTRIDGE PURCHASE
373,106 HARDWARE-NETWORKING,FIXED BUDGET,PRINTER ACCESSORIES PURCHASE
374,106 HARDWARE-NETWORKING,FIXED BUDGET,PRINTER HEAD PURCHASE
375,106 HARDWARE-NETWORKING,FIXED BUDGET,PRINTER INK PURCHASE
376,106 HARDWARE-NETWORKING,FIXED BUDGET,PRINTER TONER REFILLING CHARGES
377,106 HARDWARE-NETWORKING,FIXED BUDGET,PRINTER ACCESSORIES PURCHASE/ SERVICE
378,106 HARDWARE-NETWORKING,FIXED BUDGET,SOFTWARES LICENSE RENEWAL
379,106 HARDWARE-NETWORKING,FIXED BUDGET,DOMAIN NAME PURCHASE
380,106 HARDWARE-NETWORKING,FIXED BUDGET,DOMAIN NAME RENEWAL
381,106 HARDWARE-NETWORKING,FIXED BUDGET,GOOGLE APPS PURCHASE
382,106 HARDWARE-NETWORKING,FIXED BUDGET,GOOGLE APPS RENEWAL
383,106 HARDWARE-NETWORKING,FIXED BUDGET,OFFICE 365 PURCHASE/ OFFICE 365 RENEWAL
384,106 HARDWARE-NETWORKING,FIXED BUDGET,ACCESSORIES PURCHASE
385,106 HARDWARE-NETWORKING,FIXED BUDGET,DTH RECHARGE
386,106 HARDWARE-NETWORKING,FIXED BUDGET,HARD DISK PURCHASE
387,106 HARDWARE-NETWORKING,FIXED BUDGET,TV ACCESSORIES PURCHASE
388,106 HARDWARE-NETWORKING,FIXED BUDGET,CCTV ACCESSORIES PURCHASE
389,106 HARDWARE-NETWORKING,FIXED BUDGET,CCTV CAMERA PURCHASE
390,106 HARDWARE-NETWORKING,FIXED BUDGET,CCTV - DVR PURCHASE
391,106 HARDWARE-NETWORKING,FIXED BUDGET,AMPLIFIER PURCHASE
392,106 HARDWARE-NETWORKING,FIXED BUDGET,AUDIO SYSTEM PURCHASE
393,106 HARDWARE-NETWORKING,FIXED BUDGET,MIC PURCHASE
394,106 HARDWARE-NETWORKING,FIXED BUDGET,SPEAKER PURCHASE
395,106 HARDWARE-NETWORKING,FIXED BUDGET,NEW ASSETS PURCHASE
396,106 HARDWARE-NETWORKING,FIXED BUDGET,TV PURCHASE
397,106 HARDWARE-NETWORKING,FIXED BUDGET,HDMI EXTENTER PURCHASE
398,106 HARDWARE-NETWORKING,FIXED BUDGET,MONTHLY BILL - TELEPHONE PAYMENT
399,106 HARDWARE-NETWORKING,FIXED BUDGET,BROADBAND BILLPAYMENT
400,106 HARDWARE-NETWORKING,FIXED BUDGET,MONTHLY BILL - TELEPHONE PAYMENT
401,106 HARDWARE-NETWORKING,FIXED BUDGET,NEW CONNECTION PURCHASE
402,106 HARDWARE-NETWORKING,FIXED BUDGET,NEW CONNECTION PURCHASE
403,106 HARDWARE-NETWORKING,FIXED BUDGET,CUG SIM - INTERNET PERMISSION
404,106 HARDWARE-NETWORKING,FIXED BUDGET,DATA CARD SIM PLAN CHANGE
405,106 HARDWARE-NETWORKING,FIXED BUDGET,MOBILE AND SIM CARD ISSUE POLICY
406,106 HARDWARE-NETWORKING,FIXED BUDGET,NEW DATA CARD SIM ISSUE
407,106 HARDWARE-NETWORKING,FIXED BUDGET,NEW INTERCOM PURCHASE
408,106 HARDWARE-NETWORKING,FIXED BUDGET,TELEPHONE DEVICE PURCHASE
409,106 HARDWARE-NETWORKING,FIXED BUDGET,HOTSPOT PURCHASE
410,106 HARDWARE-NETWORKING,FIXED BUDGET,MODAM PURCHASE
411,106 HARDWARE-NETWORKING,FIXED BUDGET,DATABASE SOFTWARE PURCHASE
412,106 HARDWARE-NETWORKING,FIXED BUDGET,ACCESSORIES PURCHASE
413,107 PUR OFFICE TEAM,INTERNAL REQUEST,JEWELLERY - SOFTWARE CALCULATION ALTER - IT
414,28 ELECTRICAL,FIXED BUDGET,AMC RENEWAL PAYMENT
415,28 ELECTRICAL,FIXED BUDGET,CHEMICAL PURCHASE PAYMENT
416,28 ELECTRICAL,FIXED BUDGET,GENSET OIL SERVICE 
417,92 PROJECT,FIXED BUDGET,AC MATERIAL PURCHASE AND LABOUR CHARGE
418,92 PROJECT,FIXED BUDGET,AMC RENEWAL PAYMENT
419,28 ELECTRICAL,FIXED BUDGET,MONTHLY EB BILL PAYMENT
420,28 ELECTRICAL,FIXED BUDGET,EB DEPOSIT PAYMENT
421,28 ELECTRICAL,FIXED BUDGET,ELECTRICAL MATERIAL PURCHASE AND LABOUR CHARGES
422,28 ELECTRICAL,FIXED BUDGET,AMC RENEWAL PAYMENT
423,30 OFFICE,FIXED BUDGET,WATER PURCHASE APPROVAL
424,30 OFFICE,FIXED BUDGET,GREEN TODAY - MATERIAL PURCHASE FOR OWN USE
425,30 OFFICE,FIXED BUDGET,GREEN TODAY - CLEANING MATERIAL PURCHASE FOR DONATING
426,28 ELECTRICAL,INTERNAL REQUEST,WINDMILL APPROVALS
427,30 OFFICE,INTERNAL REQUEST,JEWELLERY COMMON APPROVAL
428,95 HR DEPT,FIXED BUDGET,STAFF UNIFORM STITCHING PAYMENT
429,95 HR DEPT,INTERNAL REQUEST,STAFF NAME DELETE REQUEST APPROVAL
430,92 PROJECT,FIXED BUDGET,NEW PRODUCT PURCHASE
431,106 HARDWARE-NETWORKING,FIXED BUDGET,AMC
432,106 HARDWARE-NETWORKING,FIXED BUDGET,CCTV ONLINE RADIO PAYMENT APPROVAL 
433,106 HARDWARE-NETWORKING,FIXED BUDGET,CCTV MONTHLY LEASED LINE PAYMENT APPROVAL 
434,92 PROJECT,FIXED BUDGET,SOIL TEST PAYMENT APPROVAL
435,92 PROJECT,FIXED BUDGET,SOIL TEST PAYMENT APPROVAL
436,30 OFFICE,FIXED BUDGET,NEWS PAPER PURCHASE
437,30 OFFICE,INTERNAL REQUEST,COMMON INFORMATION AND APPROVALS
438,100 LIFT / ESCALATOR,FIXED BUDGET,AMC RENEWAL PAYMENT
439,28 ELECTRICAL,FIXED BUDGET,AMC RENEWAL PAYMENT 
440,28 ELECTRICAL,FIXED BUDGET,GENSET MATERIAL PURCHASE  & LABOUR CHARGES 
441,28 ELECTRICAL,FIXED BUDGET,GENSET OIL SERVICE 
442,28 ELECTRICAL,FIXED BUDGET,GENSET MATERIAL PURCHASE  & LABOUR CHARGES
443,106 HARDWARE-NETWORKING,FIXED BUDGET,WEB HOSTING
444,106 HARDWARE-NETWORKING,FIXED BUDGET,HEAD PHONE PURCHASE
445,30 OFFICE,FIXED BUDGET,NEW MACHINE PURCHASE APPROVAL
446,106 HARDWARE-NETWORKING,FIXED BUDGET,INTERNET BILL PAYMENT
447,30 OFFICE,FIXED BUDGET,AKNC DONATION FOR EDUCATION
448,92 PROJECT,FIXED BUDGET,ARCHITECT INTERIOR 3D CONSULTING FEES
449,92 PROJECT,FIXED BUDGET,ADVOCATE CONSULTING FEES
450,92 PROJECT,FIXED BUDGET,ARCHITECT STRUCTURAL CONSULTING FEES
451,92 PROJECT,FIXED BUDGET,AC CONSULTING FEES
452,92 PROJECT,FIXED BUDGET,KITCHAN CONSULTING FEES
453,92 PROJECT,FIXED BUDGET,ELECTRICAL CONSULTING FEES
454,92 PROJECT,FIXED BUDGET,ARCHITECT INTERIOR 2D CONSULTING FEES
455,30 OFFICE,INTERNAL REQUEST,NT EXPENSES HEAD BUDGET ADD APPROVAL
456,92 PROJECT,FIXED BUDGET,LIFT PURCHASE APPROVAL
457,30 OFFICE,FIXED BUDGET,AKNC CANTEEN NEW MEMBERS ADD
458,36 INFO TECH,FIXED BUDGET,SW CONSULTATING / SERVICE CHARGES
459,28 ELECTRICAL,FIXED BUDGET,ELECTRICAL MATERIAL & LABOUR CHARGES APPROVAL
460,36 INFO TECH,IMPLEMENTATION,MD INSTRUCTED PROCESS APPROVALS
461,98 SALES TEAM,INTERNAL REQUEST,SALES -NEW IMPLEMENTATION 
462,98 SALES TEAM,INTERNAL REQUEST,SALES -WEEKLY INCENTIVE 
463,98 SALES TEAM,INTERNAL REQUEST,SPECIAL DISCOUNT SCHEME APPROVAL
464,98 SALES TEAM,INTERNAL REQUEST,BRANCH MANAGERS MEETING 
465,98 SALES TEAM,INTERNAL REQUEST,VIDEO CONFERENCE MEETING APPROVAL
466,98 SALES TEAM,INTERNAL REQUEST,MONTH AND YEAR CODE CHANGE COMMON APPROVAL
467,98 SALES TEAM,INTERNAL REQUEST,RATE CHANGE AND CREDIT NOTE APPROVAL ( READYMADE GROUP )
468,98 SALES TEAM,INTERNAL REQUEST,RATE CHANGE AND CREDIT NOTE APPROVAL ( TEXTILE GROUP )
469,98 SALES TEAM,INTERNAL REQUEST,MONTH BUNDLE STOCK LESS APPROVAL ( READYMADE GROUP )
470,98 SALES TEAM,INTERNAL REQUEST,DEAD STOCKLESS APPROVAL (READYMADE)
471,98 SALES TEAM,INTERNAL REQUEST,DEAD STOCKLESS APPROVAL (TEXTILES)
472,98 SALES TEAM,INTERNAL REQUEST,NEW BRANCH OPENING DISCOUNT APPROVAL
473,98 SALES TEAM,INTERNAL REQUEST,DISCOUNT APPROVAL-READY MADE GROUP
474,98 SALES TEAM,INTERNAL REQUEST,DISCOUNT APPROVAL-TEXTILE GROUP
475,98 SALES TEAM,INTERNAL REQUEST,MONTH BUNDLE STOCK LESS APPROVAL ( TEXTILE  GROUP )
476,98 SALES TEAM,INTERNAL REQUEST,SOCIETY ORDER CUSTOMER DISCOUNT APPROVAL
477,98 SALES TEAM,INTERNAL REQUEST,STALL WANTED  APPROVAL
478,98 SALES TEAM,INTERNAL REQUEST,FLOOR / SECTION INTER CHANGE APPROVAL
479,98 SALES TEAM,INTERNAL REQUEST,BRANCH WANTED VALUE ADD APPROVAL
480,98 SALES TEAM,INTERNAL REQUEST,APPROXIMATE RATE READY MADE
481,98 SALES TEAM,INTERNAL REQUEST,APPROXIMATE RATE TEXTILE
482,98 SALES TEAM,INTERNAL REQUEST,MRP RATE CHANGE APPROVAL - READY MADE
483,98 SALES TEAM,INTERNAL REQUEST,MRP RATE CHANGE APPROVAL - TEXTILE
484,95 HR DEPT,INTERNAL REQUEST,STAFF / SUPPLIER MARRIAGE ON DUTY APPROVAL
485,95 HR DEPT,INTERNAL REQUEST,BRANCH VISIT APPROVAL
486,95 HR DEPT,INTERNAL REQUEST,STAFF SECTION CHANGE ABOVE SUPERVISOR
487,95 HR DEPT,INTERNAL REQUEST,STAFF SECTION CHANGE UPTO SUPERVISOR
488,95 HR DEPT,INTERNAL REQUEST,SECTION AND DESIGNATION CHANGE
489,95 HR DEPT,INTERNAL REQUEST,STAFF REJOIN
490,95 HR DEPT,INTERNAL REQUEST,STAFF BASIC INCREMENT
491,95 HR DEPT,INTERNAL REQUEST,STAFF BASIC FIX 
492,95 HR DEPT,INTERNAL REQUEST,STAFF DESIGNATION CHANGE UPTO SUPERVISOR
493,95 HR DEPT,INTERNAL REQUEST,STAFF DESIGNATION CHANGE ABOVE SUPERVISOR
494,95 HR DEPT,INTERNAL REQUEST,STAFF REPORTING CHANGE - ADMIN
495,95 HR DEPT,INTERNAL REQUEST,STAFF REPORTING CHANGE - S - TEAM
496,95 HR DEPT,INTERNAL REQUEST,STAFF REPORTING CHANGE - MANAGEMENT
497,95 HR DEPT,INTERNAL REQUEST,STAFF REPORTING CHANGE - OPERATION
498,95 HR DEPT,INTERNAL REQUEST,NEW EMPLOYEE SECTION CREATE 
499,95 HR DEPT,INTERNAL REQUEST,NEW DESIGNATION CREATE 
500,95 HR DEPT,INTERNAL REQUEST,STAFF NAME RECOVERY
501,95 HR DEPT,INTERNAL REQUEST,STAFF BRANCH TRANSFER
502,95 HR DEPT,INTERNAL REQUEST,STAFF DEPROMOTE
503,95 HR DEPT,INTERNAL REQUEST,STAFF DEINCREMENT
504,95 HR DEPT,INTERNAL REQUEST,STAFF INCENTIVE ADD
505,95 HR DEPT,INTERNAL REQUEST,STAFF INCENTIVE SLAB FIX
506,98 SALES TEAM,INTERNAL REQUEST,MONTH AND YEAR CODE CHANGE READY MADE
507,98 SALES TEAM,INTERNAL REQUEST,MONTH AND YEAR CODE CHANGE TEXTILE
508,98 SALES TEAM,INTERNAL REQUEST,BRANCH TRANSFER INVOICE MONTH CODE CHANGE APPROVAL
509,85 ONLINE,INTERNAL REQUEST,ONLINE OVERSEAS AND DOMESTIC SERVICE PROVIDER
510,106 HARDWARE-NETWORKING,INTERNAL REQUEST,NEW SIM APPROVAL
511,106 HARDWARE-NETWORKING,INTERNAL REQUEST,EXTING SIM CHANGE APPROVAL
512,106 HARDWARE-NETWORKING,INTERNAL REQUEST,ROAMING PERMISSION
513,106 HARDWARE-NETWORKING,INTERNAL REQUEST,PLAN CHANGE APPROVAL
514,106 HARDWARE-NETWORKING,INTERNAL REQUEST,INTERNET PERMISSION APPROVAL
515,106 HARDWARE-NETWORKING,INTERNAL REQUEST,NEW MOBILE PURCHSE REQ APPROVAL AS PER POLICY (FIRST TIME)
516,106 HARDWARE-NETWORKING,INTERNAL REQUEST,NEW MOBILE PURCHSE RENEWAL REQ APPROVAL AS PER POLICY (FIRST TIME)
517,106 HARDWARE-NETWORKING,INTERNAL REQUEST,SYSTEM OPTIONS APPROVAL
518,106 HARDWARE-NETWORKING,INTERNAL REQUEST,SYSTEM REQ APPROVAL
519,106 HARDWARE-NETWORKING,INTERNAL REQUEST,HARDWARE ACCESSORIES/PERIPHERALS REQ APPROVAL
520,106 HARDWARE-NETWORKING,INTERNAL REQUEST,CTRIX USER REQ
521,106 HARDWARE-NETWORKING,INTERNAL REQUEST,DOOR ACCESS REQ
522,106 HARDWARE-NETWORKING,INTERNAL REQUEST,TAB PURCHASE
523,92 PROJECT,INTERNAL REQUEST,DRAWING APPROVAL
524,92 PROJECT,INTERNAL REQUEST,NEW WORK PERMISSION APPROVAL
525,92 PROJECT,INTERNAL REQUEST,NEW PROJECT  CONTRACTOR WORK ORDER APPROVAL
526,92 PROJECT,INTERNAL REQUEST,CIVIL CONTROCTOR LABOUR RATE APPROVAL
527,92 PROJECT,INTERNAL REQUEST,NEW SITE VISIT APPROVAL
528,92 PROJECT,INTERNAL REQUEST,NEW SITE CIVIL MATERIAL SHIFTING APPROVAL
529,92 PROJECT,INTERNAL REQUEST,NEW SITE VIECHEL PERMISSION APPROVAL
